aaron	EH R AH N
abandoned	AH B AE N D AH N D
aberdeen	AE B ER D IY N
ability	AH B IH L AH T IY
aboriginal	AE B ER IH JH AH N AH L
abortion	AH B AO R SH AH N
about	AH B AW T
above	AH B AH V
abraham	EY B R AH HH AE M
abroad	AH B R AO D
absence	AE B S AH N S
absent	AE B S AH N T
absolute	AE B S AH L UW T
absolutely	AE B S AH L UW T L IY
absorption	AH B Z AO R P SH AH N
absorption(2)	AH B S AO R P SH AH N
abstract	AE B S T R AE K T
abuse	AH B Y UW S
abuse(2)	AH B Y UW Z
academic	AE K AH D EH M IH K
academy	AH K AE D AH M IY
accent	AH K S EH N T
accent(2)	AE K S EH N T
accept	AE K S EH P T
accept(2)	AH K S EH P T
acceptable	AE K S EH P T AH B AH L
acceptable(2)	AH K S EH P T AH B AH L
acceptance	AE K S EH P T AH N S
acceptance(2)	AH K S EH P T AH N S
accepting	AE K S EH P T IH NG
accepting(2)	AH K S EH P T IH NG
access	AE K S EH S
accessibility	AE K S EH S AH B IH L IH T IY
accessible	AE K S EH S AH B AH L
accessing	AE K S EH S IH NG
accessory	AE K S EH S ER IY
accident	AE K S AH D AH N T
accommodate	AH K AA M AH D EY T
accommodation	AH K AA M AH D EY SH AH N
accompanied	AH K AH M P AH N IY D
accompanying	AH K AH M P AH N IY IH NG
accomplish	AH K AA M P L IH SH
accordance	AH K AO R D AH N S
according	AH K AO R D IH NG
accordingly	AH K AO R D IH NG L IY
account	AH K AW N T
accountability	AH K AW N T AH B IH L IH T IY
accounting	AH K AW N T IH NG
accounting(2)	AH K AW N IH NG
accreditation	AH K R EH D AH T EY SH AH N
accredited	AH K R EH D IH T IH D
accuracy	AE K Y ER AH S IY
accurate	AE K Y ER AH T
accurately	AE K Y ER AH T L IY
accused	AH K Y UW Z D
acdbentity	AE K D B EH N T AH T IY
achieve	AH CH IY V
achieved	AH CH IY V D
achievement	AH CH IY V M AH N T
achieving	AH CH IY V IH NG
acids	AE S AH D Z
acknowledge	AE K N AA L IH JH
acknowledged	AE K N AA L IH JH D
acoustic	AH K UW S T IH K
acquire	AH K W AY ER
acquired	AH K W AY ER D
acquisition	AE K W AH Z IH SH AH N
acres	EY K ER Z
acrobat	AE K R AH B AE T
across	AH K R AO S
acrylic	AH K R IH L IH K
acting	AE K T IH NG
action	AE K SH AH N
activated	AE K T IH V EY T IH D
activation	AE K T AH V EY SH AH N
active	AE K T IH V
actively	AE K T IH V L IY
activists	AE K T IH V IH S T S
activity	AE K T IH V IH T IY
actor	AE K T ER
actress	AE K T R AH S
actual	AE K CH AH W AH L
actual(2)	AE K SH AH L
actually	AE K CH UW AH L IY
actually(2)	AE K CH L IY
actually(3)	AE K SH AH L IY
acute	AH K Y UW T
adams	AE D AH M Z
adaptation	AE D AH P T EY SH AH N
adapted	AH D AE P T IH D
adapter	AH D AE P T ER
adaptive	AH D AE P T IH V
adaptor	AH D AE P T ER
added	AE D IH D
addiction	AH D IH K SH AH N
adding	AE D IH NG
addition	AH D IH SH AH N
additional	AH D IH SH AH N AH L
additionally	AH D IH SH AH N AH L IY
address	AE D R EH S
addressing	AE D R EH S IH NG
adelaide	AE D AH L EY D
adequate	AE D AH K W AH T
adequate(2)	AE D AH K W EY T
adidas	AH D IY D AH S
adipex	AE D AH P AH K S
adjacent	AH JH EY S AH N T
adjust	AH JH AH S T
adjustable	AH JH AH S T AH B AH L
adjustment	AH JH AH S T M AH N T
admin	AE D M IH N
administered	AH D M IH N IH S T ER D
administration	AE D M IH N IH S T R EY SH AH N
administrative	AH D M IH N IH S T R EY T IH V
administrator	AH D M IH N IH S T R EY T ER
admission	AE D M IH SH AH N
admission(2)	AH D M IH SH AH N
admit	AH D M IH T
admitted	AH D M IH T AH D
adobe	AH D OW B IY
adolescent	AE D AH L EH S AH N T
adolescent(2)	AE D OW L EH S AH N T
adopt	AH D AA P T
adoption	AH D AA P SH AH N
adrian	EY D R IY AH N
adult	AH D AH L T
adult(2)	AE D AH L T
advance	AH D V AE N S
advanced	AH D V AE N S T
advancement	AH D V AE N S M AH N T
advantage	AE D V AE N T IH JH
adventure	AE D V EH N CH ER
adventure(2)	AH D V EH N CH ER
adverse	AE D V ER S
advert	AE D V ER T
advertise	AE D V ER T AY Z
advertisement	AE D V ER T AH Z M AH N T
advertisement(2)	AE D V ER T AY Z M AH N T
advertiser	AE D V ER T AY Z ER
advertising	AE D V ER T AY Z IH NG
advice	AE D V AY S
advice(2)	AH D V AY S
advise	AE D V AY Z
advise(2)	AH D V AY Z
advised	AE D V AY Z D
advised(2)	AH D V AY Z D
advisor	AE D V AY Z ER
advisory	AE D V AY Z ER IY
advocacy	AE D V AH K AH S IY
advocate	AE D V AH K AH T
advocate(2)	AE D V AH K EY T
adware	AE D W AH R
aerial	EH R IY AH L
aerospace	EH R OW S P EY S
affair	AH F EH R
affect	AH F EH K T
affecting	AH F EH K T IH NG
affiliate	AH F IH L IY EY T
affiliate(2)	AH F IH L IY AH T
affiliated	AH F IH L IY EY T IH D
affiliation	AH F IH L IY EY SH AH N
afford	AH F AO R D
affordable	AH F AO R D AH B AH L
afghanistan	AE F G AE N AH S T AE N
afraid	AH F R EY D
africa	AE F R IH K AA
african	AE F R IH K AA N
after	AE F T ER
afternoon	AE F T ER N UW N
afterwards	AE F T ER W ER D Z
again	AH G EH N
again(2)	AH G EY N
against	AH G EH N S T
against(2)	AH G EY N S T
agency	EY JH AH N S IY
agenda	AH JH EH N D AH
agent	EY JH AH N T
aggregate	AE G R AH G AH T
aggregate(2)	AE G R AH G EY T
aggressive	AH G R EH S IH V
aging	EY JH IH NG
agree	AH G R IY
agreed	AH G R IY D
agreement	AH G R IY M AH N T
agricultural	AE G R IH K AH L CH ER AH L
agriculture	AE G R IH K AH L CH ER
ahead	AH HH EH D
aimed	EY M D
aircraft	EH R K R AE F T
airfare	EH R F EH R
airline	EH R L AY N
airplane	EH R P L EY N
airport	EH R P AO R T
alabama	AE L AH B AE M AH
alarm	AH L AA R M
alaska	AH L AE S K AH
albania	AE L B EY N IY AH
albany	AO L B AH N IY
albert	AE L B ER T
alberta	AE L B ER T AH
album	AE L B AH M
albuquerque	AE L B AH K ER K IY
alcohol	AE L K AH HH AA L
alert	AH L ER T
alexander	AE L IH G Z AE N D ER
alexandria	AE L AH G Z AE N D R IY AH
alfred	AE L F R IH D
algebra	AE L JH AH B R AH
algeria	AE L JH IH R IY AH
algorithm	AE L G ER IH DH AH M
alias	EY L IY AH S
alice	AE L IH S
alien	EY L IY AH N
align	AH L AY N
alignment	AH L AY N M AH N T
alike	AH L AY K
alive	AH L AY V
allah	AA L AH
allan	AE L AH N
alleged	AH L EH JH D
allen	AE L AH N
allergy	AE L ER JH IY
alliance	AH L AY AH N S
allied	AH L AY D
allied(2)	AE L AY D
allocated	AE L AH K EY T IH D
allocation	AE L AH K EY SH AH N
allow	AH L AW
allowance	AH L AW AH N S
allowing	AH L AW IH NG
alloy	AE L OY
almost	AO L M OW S T
alone	AH L OW N
along	AH L AO NG
alpha	AE L F AH
alphabetical	AE L F AH B EH T IH K AH L
alpine	AE L P AY N
already	AO L R EH D IY
already(2)	AO R EH D IY
alter	AO L T ER
alternate	AO L T ER N AH T
alternate(2)	AO L T ER N EY T
alternative	AO L T ER N AH T IH V
alternatively	AO L T ER N AH T IH V L IY
although	AO L DH OW
aluminium	AH L UW M IH N AH M
aluminium(2)	AE L Y UW M IH N AH M
aluminum	AH L UW M AH N AH M
alumni	AH L AH M N AY
always	AO L W EY Z
always(2)	AO L W IY Z
amanda	AH M AE N D AH
amateur	AE M AH CH ER
amateur(2)	AE M AH T ER
amazing	AH M EY Z IH NG
amazon	AE M AH Z AA N
ambassador	AE M B AE S AH D ER
ambien	AE M B IY AH N
ambient	AE M B IY AH N T
amendment	AH M EH N D M AH N T
amenities	AH M EH N AH T IY Z
america	AH M EH R IH K AH
american	AH M EH R IH K AH N
amongst	AH M AH NG S T
amount	AH M AW N T
ampland	AE M P L AH N D
amplifier	AE M P L AH F AY ER
amsterdam	AE M S T ER D AE M
anaheim	AE N AH HH AY M
analog	AE N AH L AO G
analyses	AE N AE L IH S IY Z
analyses(2)	AE N AH L AY Z IH Z
analysis	AE N AE L IH S IH S
analyst	AE N AH L IH S T
analytical	AE N AH L IH T IH K AH L
analyze	AE N AH L AY Z
analyzed	AE N AH L AY Z D
anatomy	AH N AE T AH M IY
anchor	AE NG K ER
ancient	EY N CH AH N T
ancient(2)	EY N SH AH N T
anderson	AE N D ER S AH N
andorra	AE N D AO R AH
angela	AE N JH AH L AH
angeles	AE N JH AH L IH S
angola	AE NG G OW L AH
animal	AE N AH M AH L
animated	AE N AH M EY T IH D
animation	AE N AH M EY SH AH N
anniversary	AE N AH V ER S ER IY
annotated	AE N AH T EY T IH D
annotation	AE N AH T EY SH AH N
announce	AH N AW N S
announced	AH N AW N S T
announcement	AH N AW N S M EH N T
annoying	AH N OY IH NG
annual	AE N Y UW AH L
annually	AE N Y UW AH L IY
anonymous	AH N AA N AH M AH S
another	AH N AH DH ER
answer	AE N S ER
answering	AE N S ER IH NG
antarctica	AE N T AA R K T IH K AH
antarctica(2)	AE N AA R T IH K AH
antenna	AE N T EH N AH
anthony	AE N TH AO N IY
anthropology	AE N TH R AH P AA L AH JH IY
antibody	AE N T IH B AA D IY
antibody(2)	AE N T IY B AA D IY
anticipated	AE N T IH S AH P EY T AH D
anticipated(2)	AE N T IH S AH P EY T IH D
antigua	AE N T IY G W AH
antique	AE N T IY K
antivirus	AE N T AY V AY R AH S
antonio	AE N T OW N IY OW
anxiety	AE NG Z AY AH T IY
anybody	EH N IY B AH D IY
anymore	EH N IY M AO R
anyone	EH N IY W AH N
anything	EH N IY TH IH NG
anytime	EH N IY T AY M
anyway	EH N IY W EY
anywhere	EH N IY W EH R
anywhere(2)	EH N IY HH W EH R
apache	AH P AE CH IY
apart	AH P AA R T
apartment	AH P AA R T M AH N T
apnic	AE P N AH K
apollo	AH P AA L OW
apparatus	AE P ER AE T AH S
apparel	AH P AE R AH L
apparent	AH P EH R AH N T
apparently	AH P EH R AH N T L IY
appeal	AH P IY L
appear	AH P IH R
appearance	AH P IH R AH N S
appearing	AH P IH R IH NG
appendix	AH P EH N D IH K S
apple	AE P AH L
appliance	AH P L AY AH N S
applicable	AE P L AH K AH B AH L
applicant	AE P L IH K AH N T
application	AE P L AH K EY SH AH N
apply	AH P L AY
applying	AH P L AY IH NG
appointed	AH P OY N T AH D
appointed(2)	AH P OY N T IH D
appointment	AH P OY N T M AH N T
appraisal	AH P R EY Z AH L
appreciate	AH P R IY SH IY EY T
appreciated	AH P R IY SH IY EY T IH D
appreciation	AH P R IY SH IY EY SH AH N
approach	AH P R OW CH
appropriate	AH P R OW P R IY AH T
appropriate(2)	AH P R OW P R IY EY T
appropriations	AH P R OW P R IY EY SH AH N Z
approval	AH P R UW V AH L
approve	AH P R UW V
approved	AH P R UW V D
approx	AE P R AH K S
approximate	AH P R AA K S AH M AH T
approximate(2)	AH P R AA K S AH M EY T
approximately	AH P R AA K S AH M AH T L IY
april	EY P R AH L
aquarium	AH K W EH R IY AH M
aquatic	AH K W AA T IH K
aquatic(2)	AH K W AE T IH K
arabia	AH R EY B IY AH
arabic	AE R AH B IH K
arabic(2)	EH R AH B IH K
arbitrary	AA R B AH T R EH R IY
arbitrary(2)	AA R B IH T R EH R IY
arbitration	AA R B IH T R EY SH AH N
arbor	AA R B ER
arcade	AA R K EY D
architect	AA R K AH T EH K T
architectural	AA R K AH T EH K CH ER AH L
architecture	AA R K AH T EH K CH ER
archive	AA R K AY V
archived	AA R K AY V D
arctic	AA R K T IH K
arctic(2)	AA R T IH K
areas	EH R IY AH Z
arena	ER IY N AH
argentina	AA R JH AH N T IY N AH
argue	AA R G Y UW
argued	AA R G Y UW D
argument	AA R G Y AH M AH N T
arise	ER AY Z
arising	ER AY Z IH NG
arizona	EH R IH Z OW N AH
arkansas	AA R K AH N S AA
arlington	AA R L IH NG T AH N
armed	AA R M D
armenia	AA R M IY N IY AH
armor	AA R M ER
armstrong	AA R M S T R AA NG
armstrong(2)	AA R M S T R AO NG
arnold	AA R N AH L D
around	ER AW N D
around(2)	ER AW N
arranged	ER EY N JH D
arrangement	ER EY N JH M AH N T
array	ER EY
arrest	ER EH S T
arrival	ER AY V AH L
arrive	ER AY V
arrived	ER AY V D
arrow	AE R OW
arrow(2)	EH R OW
arthritis	AA R TH R AY T AH S
arthritis(2)	AA R TH R AY T IH S
arthur	AA R TH ER
article	AA R T AH K AH L
article(2)	AA R T IH K AH L
artificial	AA R T AH F IH SH AH L
artist	AA R T AH S T
artist(2)	AA R T IH S T
artistic	AA R T IH S T IH K
artwork	AA R T W ER K
aruba	ER UW B AH
asbestos	AE S B EH S T AH S
ascii	AE S K IY
ashley	AE SH L IY
asian	EY ZH AH N
aside	AH S AY D
asked	AE S K T
asked(2)	AE S T
asking	AE S K IH NG
aspect	AE S P EH K T
assault	AH S AO L T
assembled	AH S EH M B AH L D
assembly	AH S EH M B L IY
assess	AH S EH S
assessing	AH S EH S IH NG
assessment	AH S EH S M AH N T
asset	AE S EH T
assign	AH S AY N
assignment	AH S AY N M AH N T
assist	AH S IH S T
assistance	AH S IH S T AH N S
assistant	AH S IH S T AH N T
associate	AH S OW S IY AH T
associate(2)	AH S OW S IY EY T
associate(3)	AH S OW SH IY AH T
associate(4)	AH S OW SH IY EY T
associated	AH S OW S IY EY T AH D
associated(2)	AH S OW SH IY EY T AH D
association	AH S OW S IY EY SH AH N
association(2)	AH S OW SH IY EY SH AH N
assume	AH S UW M
assumed	AH S UW M D
assuming	AH S UW M IH NG
assumption	AH S AH M P SH AH N
assurance	AH SH UH R AH N S
assure	AH SH UH R
assured	AH SH UH R D
asthma	AE Z M AH
astrology	AH S T R AA L AH JH IY
astronomy	AH S T R AA N AH M IY
asylum	AH S AY L AH M
athens	AE TH AH N Z
athletes	AE TH L IY T S
athletic	AE TH L EH T IH K
atlanta	AE T L AE N T AH
atlantic	AH T L AE N T IH K
atlas	AE T L AH S
atmosphere	AE T M AH S F IH R
atmospheric	AE T M AH S F EH R IH K
atomic	AH T AA M IH K
attach	AH T AE CH
attachment	AH T AE CH M AH N T
attack	AH T AE K
attempt	AH T EH M P T
attempting	AH T EH M P T IH NG
attend	AH T EH N D
attendance	AH T EH N D AH N S
attending	AH T EH N D IH NG
attention	AH T EH N SH AH N
attitude	AE T AH T UW D
attorney	AH T ER N IY
attract	AH T R AE K T
attraction	AH T R AE K SH AH N
attractive	AH T R AE K T IH V
attribute	AH T R IH B Y UW T
auburn	AA B ER N
auckland	AA K L AH N D
auction	AA K SH AH N
auction(2)	AO K SH AH N
audience	AA D IY AH N S
audience(2)	AO D IY AH N S
audio	AA D IY OW
audit	AO D IH T
auditor	AO D IH T ER
august	AA G AH S T
august(2)	AO G AH S T
aurora	ER AO R AH
austin	AO S T AH N
australia	AO S T R EY L Y AH
australian	AO S T R EY L Y AH N
austria	AO S T R IY AH
authentic	AH TH EH N T IH K
authentic(2)	AO TH EH N T IH K
authentic(3)	AO TH EH N IH K
authentic(4)	AH TH EH N IH K
authentication	AO TH EH N T AH K EY SH AH N
author	AO TH ER
authority	AH TH AO R AH T IY
authorization	AO TH ER AH Z EY SH AH N
authorized	AO TH ER AY Z D
automated	AO T AH M EY T IH D
automatic	AO T AH M AE T IH K
automatic(2)	AO T OW M AE T IH K
automatically	AO T AH M AE T IH K L IY
automatically(2)	AO T OW M AE T IH K L IY
automation	AO T AH M EY SH AH N
automobile	AO T AH M OW B IY L
automotive	AO T AH M OW T IH V
autos	AO T OW Z
autumn	AO T AH M
availability	AH V EY L AH B IH L AH T IY
availability(2)	AH V EY L AH B IH L IH T IY
available	AH V EY L AH B AH L
avatar	AE V AH T AA R
avenue	AE V AH N UW
average	AE V ER IH JH
average(2)	AE V R IH JH
aviation	EY V IY EY SH AH N
avoid	AH V OY D
avoiding	AH V OY D IH NG
award	AH W AO R D
aware	AH W EH R
awareness	AH W EH R N AH S
awesome	AA S AH M
awesome(2)	AO S AH M
awful	AA F AH L
awful(2)	AO F AH L
azerbaijan	AA Z ER B AY JH AA N
azerbaijan(2)	AE Z ER B AY JH AA N
bachelor	B AE CH AH L ER
bachelor(2)	B AE CH L ER
backed	B AE K T
background	B AE K G R AW N D
backing	B AE K IH NG
backup	B AE K AH P
bacteria	B AE K T IH R IY AH
bacterial	B AE K T IH R IY AH L
baghdad	B AE G D AE D
bahamas	B AH HH AA M AH Z
bahrain	B AA R EY N
bahrain(2)	B AY R EY N
bailey	B EY L IY
baking	B EY K IH NG
balance	B AE L AH N S
balanced	B AE L AH N S T
ballet	B AE L EY
balloon	B AH L UW N
ballot	B AE L AH T
baltimore	B AO L T AH M AO R
banana	B AH N AE N AH
bandwidth	B AE N D W IH D TH
bangbus	B AE NG B AH S
bangkok	B AE NG K AA K
bangladesh	B AE NG L AH D EH SH
banking	B AE NG K IH NG
bankruptcy	B AE NG K R AH P S IY
bankruptcy(2)	B AE NG K R AH P T S IY
banned	B AE N D
banner	B AE N ER
baptist	B AE P T AH S T
baptist(2)	B AE P T IH S T
barbados	B AA R B EY D OW S
barbara	B AA R B ER AH
barbara(2)	B AA R B R AH
barbie	B AA R B IY
barcelona	B AA R S IH L OW N AH
barely	B EH R L IY
bargain	B AA R G AH N
bargain(2)	B AA R G IH N
barnes	B AA R N Z
barrel	B AE R AH L
barrel(2)	B EH R AH L
baseball	B EY S B AO L
baseline	B EY S L AY N
basement	B EY S M AH N T
basename	B EY S N EY M
basically	B EY S IH K L IY
basket	B AE S K AH T
basketball	B AE S K AH T B AO L
bathroom	B AE TH R UW M
batman	B AE T M AE N
battery	B AE T ER IY
battle	B AE T AH L
battlefield	B AE T AH L F IY L D
beach	B IY CH
beads	B IY D Z
beans	B IY N Z
bearing	B EH R IH NG
bears	B EH R Z
beast	B IY S T
beastality	B IY S T AH L AH T IY
beastiality	B IY S T IY AH L AH T IY
beatles	B IY T AH L Z
beats	B IY T S
beautiful	B Y UW T AH F AH L
beautifully	B Y UW T AH F L IY
beauty	B Y UW T IY
beaver	B IY V ER
became	B IH K EY M
became(2)	B IY K EY M
because	B IH K AO Z
because(2)	B IH K AH Z
because(3)	B IH K AA Z
become	B IH K AH M
becoming	B IH K AH M IH NG
bedding	B EH D IH NG
bedford	B EH D F ER D
bedroom	B EH D R UW M
before	B IH F AO R
before(2)	B IY F AO R
began	B IH G AE N
began(2)	B IY G AE N
begin	B IH G IH N
beginner	B IH G IH N ER
beginning	B IH G IH N IH NG
begun	B IH G AH N
begun(2)	B EY G AH N
behalf	B IH HH AE F
behavior	B IH HH EY V Y ER
behavioral	B IH HH EY V Y ER AH L
behavioral(2)	B IY HH EY V Y ER AH L
behaviour	B IH HH EY V Y ER
behind	B IH HH AY N D
beijing	B EY ZH IH NG
being	B IY IH NG
belarus	B EH L AA R UH S
belfast	B EH L F AE S T
belgium	B EH L JH AH M
belief	B IH L IY F
believe	B IH L IY V
believed	B IH L IY V D
belize	B EH L IY Z
belkin	B EH L K IH N
belle	B EH L
belly	B EH L IY
belong	B IH L AO NG
below	B IH L OW
below(2)	B IY L OW
belts	B EH L T S
bench	B EH N CH
benchmark	B EH N CH M AA R K
beneath	B IH N IY TH
beneficial	B EH N AH F IH SH AH L
benefit	B EH N AH F IH T
benjamin	B EH N JH AH M AH N
bennett	B EH N AH T
bennett(2)	B EH N IH T
berkeley	B ER K L IY
berlin	B ER L IH N
bermuda	B ER M Y UW D AH
bernard	B ER N AA R D
bernard(2)	B ER N ER D
berry	B EH R IY
beside	B IH S AY D
beside(2)	B IY S AY D
bestiality	B EH S CH AE L IH T IY
bestsellers	B EH S T S EH L ER Z
bestsellers(2)	B EH S EH L ER Z
better	B EH T ER
betty	B EH T IY
between	B IH T W IY N
between(2)	B IY T W IY N
beverage	B EH V ER IH JH
beverage(2)	B EH V R IH JH
beverly	B EH V ER L IY
beyond	B IH AA N D
beyond(2)	B IY AO N D
beyond(3)	B IH AO N D
bhutan	B UW T AE N
bhutan(2)	B AH T AA N
bible	B AY B AH L
biblical	B IH B L AH K AH L
biblical(2)	B IH B L IH K AH L
bibliographic	B IH B L IY AH G R AE F IH K
bibliography	B IH B L IY AA G R AH F IY
bicycle	B AY S IH K AH L
bidder	B IH D ER
bidding	B IH D IH NG
bigger	B IH G ER
biggest	B IH G AH S T
bikes	B AY K S
bikini	B IH K IY N IY
bills	B IH L Z
billy	B IH L IY
binary	B AY N AH R IY
binding	B AY N D IH NG
bingo	B IH NG G OW
biodiversity	B AY OW D AY V ER S AH T IY
biography	B AY AA G R AH F IY
biological	B AY AH L AA JH IH K AH L
biology	B AY AA L AH JH IY
biotechnology	B AY OW T EH K N AA L AH JH IY
birds	B ER D Z
birmingham	B ER M IH NG HH AE M
birth	B ER TH
birthday	B ER TH D EY
bishop	B IH SH AH P
bitch	B IH CH
bizarre	B AH Z AA R
bizarre(2)	B IH Z AA R
bizrate	B IH Z R EY T
black	B L AE K
blackberry	B L AE K B EH R IY
blackjack	B L AE K JH AE K
blade	B L EY D
blair	B L EH R
blake	B L EY K
blame	B L EY M
blank	B L AE NG K
blanket	B L AE NG K AH T
blanket(2)	B L AE NG K IH T
blast	B L AE S T
bleeding	B L IY D IH NG
blend	B L EH N D
bless	B L EH S
blind	B L AY N D
blink	B L IH NG K
block	B L AA K
blocking	B L AA K IH NG
blogger	B L AO G ER
blogging	B L AO G IH NG
blogs	B L AO G Z
blond	B L AA N D
blonde	B L AA N D
blood	B L AH D
bloody	B L AH D IY
bloom	B L UW M
bloomberg	B L UW M B ER G
blowing	B L OW IH NG
blowjob	B L OW JH AA B
blues	B L UW Z
bluetooth	B L UW T UW TH
boating	B OW T IH NG
bolivia	B AH L IH V IY AH
bolivia(2)	B OW L IH V IY AH
bondage	B AA N D IH JH
booking	B UH K IH NG
bookmark	B UH K M AA R K
bookstore	B UH K S T AO R
boolean	B UW L IY AH N
border	B AO R D ER
boring	B AO R IH NG
borough	B ER OW
bosnia	B AA Z N IY AH
boston	B AA S T AH N
boston(2)	B AO S T AH N
bother	B AA DH ER
botswana	B AA T S W AA N AH
bottle	B AA T AH L
bottom	B AA T AH M
bought	B AA T
bought(2)	B AO T
boulder	B OW L D ER
boulevard	B UH L AH V AA R D
boundary	B AW N D ER IY
boundary(2)	B AW N D R IY
bouquet	B UW K EY
boutique	B UW T IY K
bowling	B OW L IH NG
boxing	B AA K S IH NG
bracelet	B R EY S L AH T
bracket	B R AE K IH T
bradford	B R AE D F ER D
bradley	B R AE D L IY
brain	B R EY N
brake	B R EY K
branch	B R AE N CH
brand	B R AE N D
brandon	B R AE N D AH N
brass	B R AE S
brave	B R EY V
brazil	B R AH Z IH L
brazilian	B R AH Z IH L Y AH N
breach	B R IY CH
bread	B R EH D
break	B R EY K
breakdown	B R EY K D AW N
breakfast	B R EH K F AH S T
breaking	B R EY K IH NG
breast	B R EH S T
breath	B R EH TH
breathing	B R IY DH IH NG
breed	B R IY D
breeding	B R IY D IH NG
brian	B R AY AH N
brick	B R IH K
bridal	B R AY D AH L
bride	B R AY D
bridge	B R IH JH
brief	B R IY F
briefing	B R IY F IH NG
briefly	B R IY F L IY
bright	B R AY T
brighton	B R AY T AH N
brilliant	B R IH L Y AH N T
bring	B R IH NG
bringing	B R IH NG IH NG
brisbane	B R IH Z B EY N
bristol	B R IH S T AH L
britain	B R IH T AH N
britannica	B R IH T AE N IH K AH
british	B R IH T IH SH
britney	B R IH T N IY
broad	B R AO D
broadband	B R AO D B AE N D
broadcast	B R AO D K AE S T
broadcasting	B R AO D K AE S T IH NG
broader	B R AO D ER
broadway	B R AO D W EY
brochure	B R OW SH UH R
broke	B R OW K
broken	B R OW K AH N
broker	B R OW K ER
bronze	B R AA N Z
brook	B R UH K
brooklyn	B R UH K L AH N
brooklyn(2)	B R UH K L IH N
brother	B R AH DH ER
brought	B R AO T
brown	B R AW N
browse	B R AW Z
browser	B R AW Z ER
browsing	B R AW Z IH NG
bruce	B R UW S
brunei	B R UW N AY
brunette	B R UW N EH T
brunswick	B R AH N Z W IH K
brush	B R AH SH
brussels	B R AH S AH L Z
brutal	B R UW T AH L
bryan	B R AY AH N
bryant	B R AY AH N T
bubble	B AH B AH L
budapest	B UW D AH P EH S T
budapest(2)	B UW D AH P EH SH T
budget	B AH JH IH T
buffalo	B AH F AH L OW
buffer	B AH F ER
bufing	B Y UW F AH NG
builder	B IH L D ER
building	B IH L D IH NG
bukkake	B AH K EY K
bulgaria	B AH L G EH R IY AH
bulgarian	B AH L G EH R IY AH N
bullet	B UH L AH T
bulletin	B UH L IH T AH N
bumper	B AH M P ER
bundle	B AH N D AH L
burden	B ER D AH N
bureau	B Y UH R OW
buried	B EH R IY D
burlington	B ER L IH NG T AH N
burner	B ER N ER
burning	B ER N IH NG
burton	B ER T AH N
business	B IH Z N AH S
business(2)	B IH Z N IH S
butler	B AH T L ER
butter	B AH T ER
butterfly	B AH T ER F L AY
button	B AH T AH N
buying	B AY IH NG
bytes	B AY T S
cabin	K AE B AH N
cabinet	K AE B AH N AH T
cabinet(2)	K AE B N AH T
cable	K EY B AH L
cache	K AE SH
cache(2)	K AE SH EY
cached	K AE SH T
cadillac	K AE D AH L AE K
cakes	K EY K S
calcium	K AE L S IY AH M
calculate	K AE L K Y AH L EY T
calculated	K AE L K Y AH L EY T AH D
calculated(2)	K AE L K Y AH L EY T IH D
calculation	K AE L K Y AH L EY SH AH N
calculator	K AE L K Y AH L EY T ER
calendar	K AE L AH N D ER
calgary	K AE L G ER IY
calibration	K AE L AH B R EY SH AH N
california	K AE L AH F AO R N Y AH
called	K AO L D
calling	K AO L IH NG
calls	K AO L Z
calvin	K AE L V AH N
calvin(2)	K AE L V IH N
cambodia	K AE M B OW D IY AH
cambridge	K EY M B R IH JH
camcorder	K AE M K AO R D ER
camel	K AE M AH L
camera	K AE M ER AH
camera(2)	K AE M R AH
cameron	K AE M ER AH N
cameroon	K AE M ER UW N
campaign	K AE M P EY N
campbell	K AE M B AH L
camping	K AE M P IH NG
camps	K AE M P S
campus	K AE M P AH S
canada	K AE N AH D AH
canadian	K AH N EY D IY AH N
canal	K AH N AE L
canberra	K AE N B EH R AH
cancel	K AE N S AH L
cancellation	K AE N S AH L EY SH AH N
cancelled	K AE N S AH L D
cancer	K AE N S ER
candidate	K AE N D AH D EY T
candidate(2)	K AE N AH D IH T
candle	K AE N D AH L
candy	K AE N D IY
cannon	K AE N AH N
canon	K AE N AH N
canvas	K AE N V AH S
canyon	K AE N Y AH N
capability	K EY P AH B IH L AH T IY
capable	K EY P AH B AH L
capacity	K AH P AE S AH T IY
capacity(2)	K AH P AE S IH T IY
capital	K AE P IH T AH L
capitol	K AE P IH T AH L
captain	K AE P T AH N
capture	K AE P CH ER
captured	K AE P CH ER D
carbon	K AA R B AH N
cardiac	K AA R D IY AE K
cardiff	K AA R D IH F
cardiovascular	K AA R D IY OW V AE S K Y AH L ER
cards	K AA R D Z
career	K ER IH R
carefully	K EH R F AH L IY
carey	K EH R IY
cargo	K AA R G OW
caribbean	K EH R IH B IY AH N
caring	K EH R IH NG
carlo	K AA R L OW
carmen	K AA R M AH N
carnival	K AA R N AH V AH L
carol	K AE R AH L
carol(2)	K EH R AH L
carolina	K EH R AH L AY N AH
caroline	K EH R AH L AY N
carpet	K AA R P AH T
carry	K AE R IY
carry(2)	K EH R IY
carrying	K AE R IY IH NG
carrying(2)	K EH R IY IH NG
carter	K AA R T ER
cartoon	K AA R T UW N
cartridge	K AA R T R AH JH
cartridge(2)	K AA R T R IH JH
cases	K EY S AH Z
cases(2)	K EY S IH Z
casey	K EY S IY
cashiers	K AE SH IH R Z
casino	K AH S IY N OW
casio	K AE S IY OW
cassette	K AH S EH T
casting	K AE S T IH NG
castle	K AE S AH L
casual	K AE ZH AH W AH L
catalog	K AE T AH L AO G
catalogue	K AE T AH L AO G
catalyst	K AE T AH L IH S T
catch	K AE CH
category	K AE T AH G AO R IY
catering	K EY T ER IH NG
cathedral	K AH TH IY D R AH L
catherine	K AE TH ER AH N
catherine(2)	K AE TH ER IH N
catherine(3)	K AE TH R IH N
catholic	K AE TH L IH K
cattle	K AE T AH L
caught	K AA T
caught(2)	K AO T
cause	K AA Z
cause(2)	K AO Z
caused	K AA Z D
caused(2)	K AO Z D
causing	K AA Z IH NG
causing(2)	K AO Z IH NG
caution	K AA SH AH N
caution(2)	K AO SH AH N
cayman	K EY M AH N
cedar	S IY D ER
ceiling	S IY L IH NG
celebrate	S EH L AH B R EY T
celebration	S EH L AH B R EY SH AH N
celebrity	S AH L EH B R IH T IY
celebs	S AH L EH B Z
cells	S EH L Z
cellular	S EH L Y AH L ER
celtic	S EH L T IH K
celtic(2)	K EH L T IH K
cement	S AH M EH N T
cement(2)	S IH M EH N T
cemetery	S EH M AH T EH R IY
cemetery(2)	S EH M IH T EH R IY
census	S EH N S AH S
center	S EH N T ER
center(2)	S EH N ER
central	S EH N T R AH L
centre	S EH N T ER
cents	S EH N T S
cents(2)	S EH N S
century	S EH N CH ER IY
ceramic	S ER AE M IH K
ceremony	S EH R AH M OW N IY
certain	S ER T AH N
certainly	S ER T AH N L IY
certificate	S ER T IH F IH K AH T
certification	S ER T AH F AH K EY SH AH N
certified	S ER T AH F AY D
chain	CH EY N
chair	CH EH R
chairman	CH EH R M AH N
challenge	CH AE L AH N JH
challenged	CH AE L AH N JH D
challenging	CH AE L AH N JH IH NG
chamber	CH EY M B ER
champagne	SH AE M P EY N
champion	CH AE M P IY AH N
championship	CH AE M P IY AH N SH IH P
chance	CH AE N S
chancellor	CH AE N S AH L ER
chancellor(2)	CH AE N S L ER
change	CH EY N JH
changed	CH EY N JH D
changelog	CH EY N JH L AA G
changing	CH EY N JH IH NG
channel	CH AE N AH L
chaos	K EY AA S
chapel	CH AE P AH L
chapter	CH AE P T ER
character	K EH R IH K T ER
characteristic	K EH R IH K T ER IH S T IH K
characterization	K EH R IH K T ER IH Z EY SH AH N
characterized	K EH R IH K T ER AY Z D
charge	CH AA R JH
charged	CH AA R JH D
charger	CH AA R JH ER
charging	CH AA R JH IH NG
charitable	CH AE R AH T AH B AH L
charitable(2)	CH EH R AH T AH B AH L
charity	CH EH R IH T IY
charles	CH AA R L Z
charles(2)	CH AA R AH L Z
charleston	CH AA R L S T AH N
charleston(2)	CH AA R AH L S T AH N
charlie	CH AA R L IY
charlotte	SH AA R L AH T
charm	CH AA R M
charming	CH AA R M IH NG
chart	CH AA R T
charter	CH AA R T ER
chase	CH EY S
chassis	CH AE S IY
cheap	CH IY P
cheaper	CH IY P ER
cheapest	CH IY P AH S T
cheat	CH IY T
check	CH EH K
checking	CH EH K IH NG
checklist	CH EH K L IH S T
checkout	CH EH K AW T
cheers	CH IH R Z
cheese	CH IY Z
chelsea	CH EH L S IY
chemical	K EH M IH K AH L
chemistry	K EH M IH S T R IY
cheque	CH EH K
cherry	CH EH R IY
chess	CH EH S
chest	CH EH S T
chester	CH EH S T ER
chevrolet	SH EH V R OW L EY
chevy	SH EH V IY
chevy(2)	CH EH V IY
chicago	SH AH K AA G OW
chick	CH IH K
chicken	CH IH K AH N
chief	CH IY F
child	CH AY L D
childhood	CH AY L D HH UH D
children	CH IH L D R AH N
chile	CH IH L IY
china	CH AY N AH
chinese	CH AY N IY Z
chips	CH IH P S
chocolate	CH AO K L AH T
choice	CH OY S
choir	K W AY ER
cholesterol	K AH L EH S T ER AO L
cholesterol(2)	K AH L EH S T ER AH L
choose	CH UW Z
choosing	CH UW Z IH NG
chorus	K AO R AH S
chose	CH OW Z
chosen	CH OW Z AH N
chris	K R IH S
christ	K R AY S T
christian	K R IH S CH AH N
christian(2)	K R IH S CH IH N
christianity	K R IH S CH IY AE N IH T IY
christina	K R IH S T IY N AH
christine	K R IH S T IY N
christmas	K R IH S M AH S
christopher	K R IH S T AH F ER
chrome	K R OW M
chronic	K R AA N IH K
chronicle	K R AA N IH K AH L
chrysler	K R AY S L ER
chubby	CH AH B IY
chuck	CH AH K
church	CH ER CH
cialis	S AY AH L AH S
cigarette	S IH G AH R EH T
cincinnati	S IH N S AH N AE T IY
cindy	S IH N D IY
cinema	S IH N AH M AH
cingular	S IH N G Y AH L AH R
circle	S ER K AH L
circuit	S ER K AH T
circular	S ER K Y AH L ER
circulation	S ER K Y AH L EY SH AH N
circumstances	S ER K AH M S T AE N S AH Z
circumstances(2)	S ER K AH M S T AE N S IH Z
circus	S ER K AH S
cisco	S IH S K OW
citation	S AY T EY SH AH N
cited	S AY T AH D
cited(2)	S AY T IH D
citizen	S IH T AH Z AH N
citizen(2)	S IH T IH Z AH N
citizenship	S IH T IH Z AH N SH IH P
citysearch	S IH T IY S ER CH
civic	S IH V IH K
civil	S IH V AH L
civilian	S AH V IH L Y AH N
civilization	S IH V AH L IH Z EY SH AH N
claim	K L EY M
clara	K L AE R AH
clara(2)	K L EH R AH
clarity	K L EH R AH T IY
clarity(2)	K L EH R IH T IY
clark	K L AA R K
class	K L AE S
classic	K L AE S IH K
classical	K L AE S IH K AH L
classification	K L AE S AH F AH K EY SH AH N
classified	K L AE S AH F AY D
classroom	K L AE S R UW M
clean	K L IY N
cleaner	K L IY N ER
cleaning	K L IY N IH NG
cleanup	K L IY N AH P
clear	K L IH R
clearance	K L IH R AH N S
clearing	K L IH R IH NG
clearly	K L IH R L IY
clerk	K L ER K
cleveland	K L IY V L AH N D
click	K L IH K
clicking	K L IH K IH NG
client	K L AY AH N T
cliff	K L IH F
climate	K L AY M AH T
climate(2)	K L AY M IH T
climb	K L AY M
climbing	K L AY M IH NG
clinic	K L IH N IH K
clinical	K L IH N AH K AH L
clinical(2)	K L IH N IH K AH L
clinton	K L IH N T AH N
clips	K L IH P S
clock	K L AA K
clone	K L OW N
close	K L OW S
close(2)	K L OW Z
closed	K L OW Z D
closely	K L OW S L IY
closer	K L OW S ER
closer(2)	K L OW Z ER
closest	K L OW S AH S T
closing	K L OW Z IH NG
closure	K L OW ZH ER
cloth	K L AO TH
clothing	K L OW DH IH NG
cloud	K L AW D
cloudy	K L AW D IY
clubs	K L AH B Z
cluster	K L AH S T ER
coach	K OW CH
coaching	K OW CH IH NG
coalition	K OW AH L IH SH AH N
coast	K OW S T
coastal	K OW S T AH L
coated	K OW T AH D
coated(2)	K OW T IH D
coating	K OW T IH NG
cocks	K AA K S
cocktail	K AA K T EY L
codes	K OW D Z
coding	K OW D IH NG
coffee	K AA F IY
coffee(2)	K AO F IY
cognitive	K AA G N IH T IH V
cohen	K OW AH N
coins	K OY N Z
coleman	K OW L M AH N
colin	K OW L IH N
collaboration	K AH L AE B ER EY SH AH N
collaborative	K AH L AE B ER EY T IH V
collaborative(2)	K AH L AE B R AH T IH V
collapse	K AH L AE P S
collar	K AA L ER
colleague	K AA L IY G
collect	K AH L EH K T
collectables	K AA L IH K T AH B AH L Z
collectible	K AH L EH K T AH B AH L
collecting	K AH L EH K T IH NG
collection	K AH L EH K SH AH N
collective	K AH L EH K T IH V
collector	K AH L EH K T ER
college	K AA L IH JH
collins	K AA L IH N Z
cologne	K AH L OW N
colombia	K AH L AH M B IY AH
colon	K OW L AH N
colony	K AA L AH N IY
color	K AH L ER
color(2)	K AO L ER
colorado	K AA L ER AA D OW
colorado(2)	K AA L ER AE D OW
colour	K AH L ER
columbia	K AH L AH M B IY AH
columbus	K AH L AH M B AH S
column	K AA L AH M
columnists	K AA L AH M N AH S T S
combat	K AA M B AE T
combat(2)	K AH M B AE T
combination	K AA M B AH N EY SH AH N
combine	K AA M B AY N
combine(2)	K AH M B AY N
combined	K AH M B AY N D
combining	K AH M B AY N IH NG
combo	K AA M B OW
comedy	K AA M AH D IY
comes	K AH M Z
comfort	K AH M F ER T
comfortable	K AH M F ER T AH B AH L
comic	K AA M IH K
coming	K AH M IH NG
command	K AH M AE N D
commander	K AH M AE N D ER
comment	K AA M EH N T
commentary	K AA M AH N T EH R IY
commerce	K AA M ER S
commercial	K AH M ER SH AH L
commission	K AH M IH SH AH N
commissioner	K AH M IH SH AH N ER
commit	K AH M IH T
commitment	K AH M IH T M AH N T
committed	K AH M IH T IH D
committee	K AH M IH T IY
commodity	K AH M AA D AH T IY
common	K AA M AH N
commonly	K AA M AH N L IY
commonwealth	K AA M AH N W EH L TH
communicate	K AH M Y UW N AH K EY T
communication	K AH M Y UW N AH K EY SH AH N
communist	K AA M Y AH N AH S T
community	K AH M Y UW N AH T IY
community(2)	K AH M Y UW N IH T IY
compact	K AA M P AE K T
compact(2)	K AH M P AE K T
company	K AH M P AH N IY
compaq	K AA M P AE K
comparable	K AA M P R AH B AH L
comparable(2)	K AH M P AE R AH B AH L
comparative	K AH M P AE R AH T IH V
compare	K AH M P EH R
compared	K AH M P EH R D
comparing	K AH M P EH R IH NG
comparison	K AH M P EH R AH S AH N
compatibility	K AH M P AE T AH B IH L AH T IY
compatible	K AH M P AE T AH B AH L
compensation	K AA M P AH N S EY SH AH N
compete	K AH M P IY T
competent	K AA M P AH T IH N T
competing	K AH M P IY T IH NG
competition	K AA M P AH T IH SH AH N
competitive	K AH M P EH T AH T IH V
competitive(2)	K AH M P EH T IH T IH V
competitors	K AH M P EH T AH T ER Z
competitors(2)	K AH M P EH T IH T ER Z
compilation	K AA M P AH L EY SH AH N
compile	K AH M P AY L
compiled	K AH M P AY L D
compiler	K AH M P AY L ER
complaint	K AH M P L EY N T
complement	K AA M P L AH M AH N T
completed	K AH M P L IY T AH D
completed(2)	K AH M P L IY T IH D
completely	K AH M P L IY T L IY
completing	K AH M P L IY T IH NG
completion	K AH M P L IY SH AH N
complex	K AA M P L EH K S
complex(2)	K AH M P L EH K S
complexity	K AH M P L EH K S AH T IY
complexity(2)	K AH M P L EH K S IH T IY
compliance	K AH M P L AY AH N S
compliant	K AH M P L AY AH N T
complicated	K AA M P L AH K EY T AH D
complications	K AA M P L AH K EY SH AH N Z
complimentary	K AA M P L AH M EH N T ER IY
comply	K AH M P L AY
component	K AH M P OW N AH N T
composed	K AH M P OW Z D
composer	K AH M P OW Z ER
composite	K AH M P AA Z AH T
composite(2)	K AA M P AA Z AH T
composition	K AA M P AH Z IH SH AH N
compound	K AA M P AW N D
compound(2)	K AH M P AW N D
comprehensive	K AA M P R IY HH EH N S IH V
compressed	K AH M P R EH S T
compression	K AH M P R EH SH AH N
compromise	K AA M P R AH M AY Z
computation	K AA M P Y AH T EY SH AH N
computational	K AA M P Y UW T EY SH AH N AH L
compute	K AH M P Y UW T
computed	K AH M P Y UW T AH D
computed(2)	K AH M P Y UW T IH D
computer	K AH M P Y UW T ER
computing	K AH M P Y UW T IH NG
concentrate	K AA N S AH N T R EY T
concentration	K AA N S AH N T R EY SH AH N
concept	K AA N S EH P T
conceptual	K AH N S EH P CH UW AH L
concern	K AH N S ER N
concerning	K AH N S ER N IH NG
concert	K AA N S ER T
concert(2)	K AH N S ER T
conclude	K AH N K L UW D
concluded	K AH N K L UW D AH D
concluded(2)	K AH N K L UW D IH D
conclusion	K AH N K L UW ZH AH N
concord	K AA N K AO R D
concord(2)	K AA N K ER D
concrete	K AH N K R IY T
concrete(2)	K AA N K R IY T
condition	K AH N D IH SH AH N
conditional	K AH N D IH SH AH N AH L
conditioning	K AH N D IH SH AH N IH NG
condo	K AA N D OW
conduct	K AA N D AH K T
conducting	K AH N D AH K T IH NG
conference	K AA N F ER AH N S
conference(2)	K AA N F R AH N S
conferencing	K AA N F R AH N S IH NG
confidence	K AA N F AH D EH N S
confident	K AA N F AH D AH N T
confidential	K AA N F AH D EH N SH AH L
confidentiality	K AA N F AH D EH N SH IY AE L AH T IY
config	K AH N F IH G
configuration	K AH N F IH G Y ER EY SH AH N
configure	K AH N F IH G Y ER
configured	K AH N F IH G Y ER D
configuring	K AH N F IH G Y ER IH NG
confirm	K AH N F ER M
confirmation	K AA N F ER M EY SH AH N
conflict	K AA N F L IH K T
conflict(2)	K AH N F L IH K T
confused	K AH N F Y UW Z D
confusion	K AH N F Y UW ZH AH N
congo	K AA NG G OW
congratulations	K AH N G R AE CH AH L EY SH AH N Z
congress	K AA NG G R AH S
congressional	K AH N G R EH SH AH N AH L
conjunction	K AH N JH AH NG K SH AH N
connect	K AH N EH K T
connecticut	K AH N EH T AH K AH T
connecting	K AH N EH K T IH NG
connection	K AH N EH K SH AH N
connectivity	K AH N EH K T IH V IH T IY
connector	K AH N EH K T ER
conscious	K AA N SH AH S
consciousness	K AA N SH AH S N AH S
consecutive	K AH N S EH K Y AH T IH V
consensus	K AH N S EH N S AH S
consent	K AH N S EH N T
consequence	K AA N S AH K W AH N S
consequently	K AA N S AH K W AH N T L IY
consequently(2)	K AA N S AH K W EH N T L IY
conservation	K AA N S ER V EY SH AH N
conservative	K AH N S ER V AH T IH V
consider	K AH N S IH D ER
considerable	K AH N S IH D ER AH B AH L
consideration	K AH N S IH D ER EY SH AH N
considering	K AH N S IH D ER IH NG
consist	K AH N S IH S T
consistency	K AH N S IH S T AH N S IY
consistent	K AH N S IH S T AH N T
consistently	K AH N S IH S T AH N T L IY
consisting	K AH N S IH S T IH NG
console	K AA N S OW L
console(2)	K AH N S OW L
consolidated	K AH N S AA L AH D EY T AH D
consolidation	K AH N S AA L AH D EY SH AH N
consortium	K AH N S AO R SH IY AH M
consortium(2)	K AH N S AO R SH Y AH M
conspiracy	K AH N S P IH R AH S IY
const	K AA N S T
constant	K AA N S T AH N T
constantly	K AA N S T AH N T L IY
constitute	K AA N S T AH T UW T
constitution	K AA N S T AH T UW SH AH N
constitutional	K AA N S T AH T UW SH AH N AH L
constraint	K AH N S T R EY N T
construct	K AH N S T R AH K T
construct(2)	K AA N S T R AH K T
construction	K AH N S T R AH K SH AH N
consult	K AH N S AH L T
consultancy	K AH N S AH L T AH N S IY
consultant	K AH N S AH L T AH N T
consultation	K AA N S AH L T EY SH AH N
consulting	K AH N S AH L T IH NG
consumer	K AH N S UW M ER
consumption	K AH N S AH M P SH AH N
consumption(2)	K AH N S AH M SH AH N
contact	K AA N T AE K T
contacting	K AA N T AE K T IH NG
contain	K AH N T EY N
container	K AH N T EY N ER
containing	K AH N T EY N IH NG
contamination	K AH N T AE M AH N EY SH AH N
contemporary	K AH N T EH M P ER EH R IY
content	K AA N T EH N T
content(2)	K AH N T EH N T
contest	K AA N T EH S T
contest(2)	K AH N T EH S T
context	K AA N T EH K S T
continent	K AA N T AH N AH N T
continental	K AA N T AH N EH N T AH L
continental(2)	K AA N T AH N EH N AH L
continually	K AH N T IH N Y UW AH L IY
continually(2)	K AH N T IH N Y UW L IY
continue	K AH N T IH N Y UW
continued	K AH N T IH N Y UW D
continuing	K AH N T IH N Y UW IH NG
continuity	K AA N T AH N UW AH T IY
continuous	K AH N T IH N Y UW AH S
continuously	K AH N T IH N Y UW AH S L IY
contract	K AA N T R AE K T
contract(2)	K AH N T R AE K T
contracting	K AA N T R AE K T IH NG
contractor	K AA N T R AE K T ER
contrary	K AA N T R EH R IY
contrary(2)	K AH N T R EH R IY
contrast	K AA N T R AE S T
contrast(2)	K AH N T R AE S T
contribute	K AH N T R IH B Y UW T
contributed	K AH N T R IH B Y UW T IH D
contributing	K AH N T R IH B Y UW T IH NG
contribution	K AA N T R AH B Y UW SH AH N
contributor	K AH N T R IH B Y AH T ER
control	K AH N T R OW L
controlled	K AH N T R OW L D
controller	K AH N T R OW L ER
controlling	K AH N T R OW L IH NG
controversy	K AA N T R AH V ER S IY
convenience	K AH N V IY N Y AH N S
convenient	K AH N V IY N Y AH N T
convention	K AH N V EH N SH AH N
conventional	K AH N V EH N SH AH N AH L
convergence	K AH N V ER JH AH N S
conversation	K AA N V ER S EY SH AH N
conversion	K AH N V ER ZH AH N
convert	K AA N V ER T
convert(2)	K AH N V ER T
converter	K AH N V ER T ER
convertible	K AH N V ER T AH B AH L
convicted	K AH N V IH K T AH D
conviction	K AH N V IH K SH AH N
convinced	K AH N V IH N S T
cookbook	K UH K B UH K
cooked	K UH K T
cookie	K UH K IY
cooking	K UH K IH NG
cooler	K UW L ER
cooling	K UW L IH NG
cooper	K UW P ER
cooperation	K OW AA P ER EY SH AH N
cooperation(2)	K W AA P ER EY SH AH N
cooperation(3)	K W AO P ER EY SH AH N
cooperative	K OW AA P ER EY T IH V
coordinate	K OW AO R D AH N AH T
coordinate(2)	K OW AO R D AH N EY T
coordinated	K OW AO R D AH N EY T IH D
coordination	K OW AO R D AH N EY SH AH N
coordinator	K OW AO R D AH N EY T ER
copying	K AA P IY IH NG
copyright	K AA P IY R AY T
coral	K AO R AH L
cordless	K AO R D L AH S
cornell	K AO R N EH L
corner	K AO R N ER
cornwall	K AO R N W AO L
corporate	K AO R P ER AH T
corporate(2)	K AO R P R AH T
corporation	K AO R P ER EY SH AH N
corps	K AO R
corps(2)	K AO R Z
corpus	K AO R P AH S
correct	K ER EH K T
correction	K ER EH K SH AH N
correctly	K ER EH K T L IY
correlation	K AO R AH L EY SH AH N
correspondence	K AO R AH S P AA N D AH N S
corresponding	K AO R AH S P AA N D IH NG
corruption	K ER AH P SH AH N
cosmetic	K AA Z M EH T IH K
costa	K AO S T AA
costs	K AA S T S
costs(2)	K AO S T S
costume	K AA S T UW M
cottage	K AA T AH JH
cottage(2)	K AA T IH JH
cotton	K AA T AH N
cotton(2)	K AO T AH N
could	K UH D
council	K AW N S AH L
counsel	K AW N S AH L
counseling	K AW N S AH L IH NG
count	K AW N T
counter	K AW N T ER
country	K AH N T R IY
county	K AW N T IY
county(2)	K AW N IY
couple	K AH P AH L
coupled	K AH P AH L D
coupon	K UW P AO N
coupon(2)	K Y UW P AO N
courage	K ER IH JH
courier	K ER IY ER
course	K AO R S
court	K AO R T
courtesy	K ER T AH S IY
cover	K AH V ER
coverage	K AH V ER AH JH
coverage(2)	K AH V ER IH JH
coverage(3)	K AH V R IH JH
covering	K AH V ER IH NG
covering(2)	K AH V R IH NG
cowboy	K AW B OY
cradle	K R EY D AH L
crawford	K R AO F ER D
create	K R IY EY T
created	K R IY EY T AH D
created(2)	K R IY EY T IH D
creating	K R IY EY T IH NG
creation	K R IY EY SH AH N
creative	K R IY EY T IH V
creativity	K R IY EY T IH V AH T IY
creator	K R IY EY T ER
creature	K R IY CH ER
credit	K R EH D AH T
credit(2)	K R EH D IH T
cricket	K R IH K IH T
criminal	K R IH M AH N AH L
crisis	K R AY S AH S
criteria	K R AY T IH R IY AH
criterion	K R AY T IH R IY AH N
critical	K R IH T IH K AH L
criticism	K R IH T IH S IH Z AH M
critics	K R IH T IH K S
croatia	K R OW EY SH AH
crossing	K R AO S IH NG
crossword	K R AO S W ER D
crucial	K R UW SH AH L
cruise	K R UW Z
crystal	K R IH S T AH L
cubic	K Y UW B IH K
cuisine	K W IH Z IY N
cultural	K AH L CH ER AH L
culture	K AH L CH ER
cumshot	K AH M SH AH T
cumulative	K Y UW M Y AH L AH T IH V
curious	K Y UH R IY AH S
currency	K ER AH N S IY
current	K ER AH N T
current(2)	K ER N T
current(3)	K AA R AH N T
currently	K ER AH N T L IY
curriculum	K ER IH K Y AH L AH M
cursor	K ER S ER
curtis	K ER T AH S
curtis(2)	K ER T IH S
curve	K ER V
custody	K AH S T AH D IY
custom	K AH S T AH M
customer	K AH S T AH M ER
customise	K AH S T AH M AY Z
customize	K AH S T AH M AY Z
customized	K AH S T AH M AY Z D
cutting	K AH T IH NG
cyber	S AY B ER
cycle	S AY K AH L
cycling	S AY K AH L IH NG
cycling(2)	S AY K L IH NG
cylinder	S IH L AH N D ER
cylinder(2)	S IH L IH N D ER
cyprus	S AY P R AH S
czech	CH EH K
dakota	D AH K OW T AH
dallas	D AE L AH S
damage	D AE M AH JH
damage(2)	D AE M IH JH
damaged	D AE M AH JH D
damaged(2)	D AE M IH JH D
dancing	D AE N S IH NG
danger	D EY N JH ER
dangerous	D EY N JH ER AH S
daniel	D AE N Y AH L
danish	D EY N IH SH
darkness	D AA R K N AH S
darwin	D AA R W IH N
database	D EY T AH B EY S
database(2)	D AE T AH B EY S
dating	D EY T IH NG
daughter	D AO T ER
davidson	D EY V IH D S AH N
dayton	D EY T AH N
deadly	D EH D L IY
dealer	D IY L ER
dealing	D IY L IH NG
deals	D IY L Z
dealt	D EH L T
dealtime	D IY L T AY M
death	D EH TH
debate	D AH B EY T
debian	D IY B IY AH N
deborah	D EH B ER AH
deborah(2)	D EH B R AH
debug	D IY B AH G
debut	D EY B Y UW
decade	D EH K EY D
december	D IH S EH M B ER
decent	D IY S AH N T
decide	D IH S AY D
decided	D IH S AY D IH D
decimal	D EH S AH M AH L
decision	D IH S IH ZH AH N
declaration	D EH K L ER EY SH AH N
declare	D IH K L EH R
declared	D IH K L EH R D
decline	D IH K L AY N
declined	D IH K L AY N D
decor	D IH K AO R
decor(2)	D EY K AO R
decorating	D EH K ER EY T IH NG
decorative	D EH K R AH T IH V
decrease	D IH K R IY S
decrease(2)	D IY K R IY S
decreased	D IH K R IY S T
decreased(2)	D IY K R IY S T
dedicated	D EH D AH K EY T AH D
deemed	D IY M D
deeper	D IY P ER
deeply	D IY P L IY
default	D IH F AO L T
defeat	D IH F IY T
defects	D IY F EH K T S
defects(2)	D IH F EH K T S
defence	D IH F EH N S
defend	D IH F EH N D
defendant	D IH F EH N D AH N T
defense	D IH F EH N S
defensive	D IH F EH N S IH V
deferred	D IH F ER D
deficit	D EH F AH S AH T
define	D IH F AY N
defined	D IH F AY N D
defining	D IH F AY N IH NG
definitely	D EH F AH N AH T L IY
definition	D EH F AH N IH SH AH N
degree	D IH G R IY
delaware	D EH L AH W EH R
delay	D IH L EY
delegation	D EH L AH G EY SH AH N
delete	D IH L IY T
deleted	D IH L IY T AH D
delhi	D EH L IY
delicious	D IH L IH SH AH S
delight	D IH L AY T
deliver	D IH L IH V ER
delivery	D IH L IH V ER IY
delta	D EH L T AH
deluxe	D AH L AH K S
demand	D IH M AE N D
demanding	D IH M AE N D IH NG
democracy	D IH M AA K R AH S IY
democrat	D EH M AH K R AE T
democratic	D EH M AH K R AE T IH K
demographic	D EH M AH G R AE F IH K
demonstrate	D EH M AH N S T R EY T
demonstrated	D EH M AH N S T R EY T AH D
demonstrated(2)	D EH M AH N S T R EY T IH D
demonstration	D EH M AH N S T R EY SH AH N
denmark	D EH N M AA R K
dense	D EH N S
density	D EH N S AH T IY
density(2)	D EH N S IH T IY
dentists	D EH N T IH S T S
department	D IH P AA R T M AH N T
departmental	D IH P AA R T M EH N AH L
departmental(2)	D IH P AA R T M EH N T AH L
departure	D IH P AA R CH ER
depend	D IH P EH N D
dependence	D IH P EH N D AH N S
dependent	D IH P EH N D AH N T
depending	D IH P EH N D IH NG
deployment	D IH P L OY M AH N T
deposit	D AH P AA Z IH T
deposit(2)	D IH P AA Z AH T
depot	D IY P OW
depression	D IH P R EH SH AH N
depth	D EH P TH
deputy	D EH P Y AH T IY
deputy(2)	D EH P Y UW T IY
derby	D ER B IY
derek	D EH R IH K
derived	D ER AY V D
descending	D IH S EH N D IH NG
describe	D IH S K R AY B
described	D IH S K R AY B D
describing	D IH S K R AY B IH NG
description	D IH S K R IH P SH AH N
desert	D EH Z ER T
desert(2)	D IH Z ER T
deserve	D IH Z ER V
design	D IH Z AY N
designated	D EH Z IH G N EY T IH D
designation	D EH Z AH G N EY SH AH N
designation(2)	D EH Z IH G N EY SH AH N
designer	D IH Z AY N ER
designing	D IH Z AY N IH NG
desirable	D IH Z AY R AH B AH L
desirable(2)	D IH Z AY ER AH B AH L
desire	D IH Z AY ER
desired	D IH Z AY ER D
desktop	D EH S K T AA P
desperate	D EH S P R IH T
desperate(2)	D EH S P ER IH T
despite	D IH S P AY T
destination	D EH S T AH N EY SH AH N
destination(2)	D EH S T IH N EY SH AH N
destiny	D EH S T AH N IY
destroy	D IH S T R OY
destruction	D IH S T R AH K SH AH N
detail	D IH T EY L
detail(2)	D IY T EY L
detect	D IH T EH K T
detection	D IH T EH K SH AH N
detective	D IH T EH K T IH V
detector	D IH T EH K T ER
determination	D IH T ER M AH N EY SH AH N
determine	D AH T ER M AH N
determine(2)	D IH T ER M AH N
determined	D IH T ER M AH N D
determining	D IH T ER M AH N IH NG
detroit	D IH T R OY T
detroit(2)	D IY T R OY T
deutsch	D OY CH
deutsche	D OY CH
deutschland	D OY CH L AE N D
devel	D AH V EH L
develop	D IH V EH L AH P
developer	D IH V EH L AH P ER
developing	D IH V EH L AH P IH NG
development	D IH V EH L AH P M AH N T
developmental	D IH V EH L AH P M EH N T AH L
developmental(2)	D IH V EH L AH P M EH N AH L
deviant	D IY V IY AH N T
deviation	D IY V IY EY SH AH N
device	D IH V AY S
devil	D EH V AH L
devon	D EH V AH N
devoted	D IH V OW T AH D
devoted(2)	D IH V OW T IH D
diabetes	D AY AH B IY T IY Z
diagnosis	D AY AH G N OW S AH S
diagnostic	D AY AH G N AA S T IH K
diagram	D AY AH G R AE M
dialog	D AY AH L AO G
dialogue	D AY AH L AO G
diameter	D AY AE M AH T ER
diamond	D AY M AH N D
dictionary	D IH K SH AH N EH R IY
diesel	D IY S AH L
diesel(2)	D IY Z AH L
dietary	D AY AH T EH R IY
differ	D IH F ER
difference	D IH F ER AH N S
difference(2)	D IH F R AH N S
different	D IH F ER AH N T
different(2)	D IH F R AH N T
differential	D IH F ER EH N SH AH L
differently	D IH F R AH N T L IY
differently(2)	D IH F ER EH N T L IY
difficult	D IH F AH K AH L T
difficulty	D IH F AH K AH L T IY
difficulty(2)	D IH F IH K AH L T IY
digest	D AY JH EH S T
digital	D IH JH AH T AH L
digital(2)	D IH JH IH T AH L
dimension	D IH M EH N SH AH N
dimensional	D IH M EH N SH AH N AH L
dining	D AY N IH NG
dinner	D IH N ER
diploma	D IH P L OW M AA
direct	D ER EH K T
direct(2)	D AY R EH K T
direct(3)	D IH R EH K T
direction	D ER EH K SH AH N
direction(2)	D IY R EH K SH IH N
direction(3)	D AY R EH K SH IH N
direction(4)	D IH R EH K SH IH N
directive	D ER EH K T IH V
directive(2)	D IY R EH K T IH V
directive(3)	D AY R EH K T IH V
directive(4)	D IH R EH K T IH V
directly	D ER EH K T L IY
directly(2)	D IY R EH K L IY
directly(3)	D AY R EH K L IY
directly(4)	D IH R EH K L IY
director	D ER EH K T ER
director(2)	D AY R EH K T ER
director(3)	D IY R EH K T ER
director(4)	D IH R EH K T ER
directory	D ER EH K T ER IY
directory(2)	D AY R EH K T ER IY
directory(3)	D IY R EH K T ER IY
directory(4)	D IH R EH K T ER IY
disability	D IH S AH B IH L IH T IY
disability(2)	D IH S AH B IH L IH T IY Z
disable	D IH S EY B AH L
disabled	D IH S EY B AH L D
disagree	D IH S AH G R IY
disappointed	D IH S AH P OY N T IH D
disappointed(2)	D IH S AH P OY N IH D
disaster	D IH Z AE S T ER
discharge	D IH S CH AA R JH
disciplinary	D IH S AH P L AH N EH R IY
discipline	D IH S AH P L AH N
disclaimer	D IH S K L EY M ER
disclose	D IH S K L OW Z
disclosure	D IH S K L OW ZH ER
discount	D IH S K AW N T
discover	D IH S K AH V ER
discovery	D IH S K AH V ER IY
discovery(2)	D IH S K AH V R IY
discrete	D IH S K R IY T
discretion	D IH S K R EH SH AH N
discrimination	D IH S K R IH M AH N EY SH AH N
discuss	D IH S K AH S
discussing	D IH S K AH S IH NG
discussion	D IH S K AH SH AH N
disease	D IH Z IY Z
dishes	D IH SH AH Z
dishes(2)	D IH SH IH Z
disney	D IH Z N IY
disorder	D IH S AO R D ER
dispatch	D IH S P AE CH
display	D IH S P L EY
displaying	D IH S P L EY IH NG
disposal	D IH S P OW Z AH L
disposition	D IH S P AH Z IH SH AH N
dispute	D IH S P Y UW T
distance	D IH S T AH N S
distant	D IH S T AH N T
distinct	D IH S T IH NG K T
distinction	D IH S T IH NG K SH AH N
distinguished	D IH S T IH NG G W IH SH T
distribute	D IH S T R IH B Y UW T
distributed	D IH S T R IH B Y AH T AH D
distribution	D IH S T R AH B Y UW SH AH N
distributor	D IH S T R IH B Y AH T ER
district	D IH S T R IH K T
disturbed	D IH S T ER B D
diverse	D AY V ER S
diverse(2)	D IH V ER S
diversity	D IH V ER S IH T IY
diversity(2)	D AY V ER S IH T IY
divide	D IH V AY D
divided	D IH V AY D IH D
dividend	D IH V IH D EH N D
divine	D IH V AY N
diving	D AY V IH NG
division	D IH V IH ZH AH N
divorce	D IH V AO R S
doctor	D AA K T ER
doctor(2)	D AO K T ER
doctrine	D AA K T R AH N
doctrine(2)	D AO K T ER IH N
document	D AA K Y AH M EH N T
document(2)	D AA K Y UW M EH N T
documentary	D AA K Y AH M EH N T ER IY
documentary(2)	D AA K Y AH M EH N ER IY
documentary(3)	D AA K Y UW M EH N T ER IY
documentary(4)	D AA K Y UW M EH N ER IY
documentation	D AA K Y AH M EH N T EY SH AH N
documentation(2)	D AA K Y UW M EH N T EY SH AH N
dodge	D AA JH
doing	D UW IH NG
dollar	D AA L ER
dollar(2)	D AO L ER
dolls	D AA L Z
domain	D OW M EY N
domestic	D AH M EH S T IH K
dominant	D AA M AH N AH N T
dominican	D AH M IH N AH K AH N
donald	D AA N AH L D
donate	D OW N EY T
donated	D OW N EY T AH D
donated(2)	D OW N EY T IH D
donation	D OW N EY SH AH N
donna	D AA N AH
donor	D OW N ER
doors	D AO R Z
dosage	D OW S AH JH
dosage(2)	D OW S IH JH
double	D AH B AH L
doubt	D AW T
douglas	D AH G L AH S
dover	D OW V ER
download	D AW N L OW D
downloadable	D AW N L OW D AH B AH L
downloading	D AW N L OW D IH NG
downtown	D AW N T AW N
dozen	D AH Z AH N
dragon	D R AE G AH N
drainage	D R EY N AH JH
drainage(2)	D R EY N IH JH
dramatic	D R AH M AE T IH K
dramatically	D R AH M AE T IH K L IY
dramatically(2)	D R AH M AE T IH K AH L IY
drawing	D R AO IH NG
dressing	D R EH S IH NG
drilling	D R IH L IH NG
drinking	D R IH NG K IH NG
driven	D R IH V AH N
driver	D R AY V ER
driving	D R AY V IH NG
dropped	D R AA P T
dubai	D UW B AY
dublin	D AH B L IH N
duncan	D AH NG K AH N
duplicate	D UW P L AH K AH T
duplicate(2)	D UW P L AH K EY T
durable	D UH R AH B AH L
duration	D UH R EY SH AH N
durham	D ER AH M
durham(2)	D UH R HH AE M
durham(3)	D UH R AH M
during	D UH R IH NG
during(2)	D Y UH R IH NG
during(3)	D ER IH NG
dutch	D AH CH
dying	D AY IH NG
dylan	D IH L AH N
dynamic	D AY N AE M IH K
eagle	IY G AH L
earliest	ER L IY AH S T
early	ER L IY
earned	ER N D
earning	ER N IH NG
earrings	IH R IH NG Z
earrings(2)	IY R IH NG Z
earth	ER TH
earthquake	ER TH K W EY K
eastern	IY S T ER N
eating	IY T IH NG
ebony	EH B AH N IY
ebook	EH B AH K
eclipse	IH K L IH P S
eclipse(2)	AH K L IH P S
eclipse(3)	IY K L IH P S
ecological	IY K AH L AA JH IH K AH L
ecological(2)	EH K AH L AA JH IH K AH L
ecology	IH K AA L AH JH IY
ecology(2)	IY K AA L AH JH IY
ecommerce	AH K AA M AH R S
economic	EH K AH N AA M IH K
economic(2)	IY K AH N AA M IH K
economy	IH K AA N AH M IY
economy(2)	IY K AA N AH M IY
ecuador	EH K W AH D AO R
eddie	EH D IY
edgar	EH D G ER
edges	EH JH AH Z
edges(2)	EH JH IH Z
edinburgh	EH D AH N B ER OW
edited	EH D AH T AH D
edited(2)	EH D IH T IH D
editing	EH D AH T IH NG
editing(2)	EH D IH T IH NG
edition	AH D IH SH AH N
edition(2)	IH D IH SH AH N
editor	EH D AH T ER
editor(2)	EH D IH T ER
editorial	EH D AH T AO R IY AH L
edmonton	EH D M AH N T AH N
educated	EH JH AH K EY T IH D
educated(2)	EH JH Y UW K EY T IH D
education	EH JH AH K EY SH AH N
education(2)	EH JH Y UW K EY SH AH N
educational	EH JH AH K EY SH AH N AH L
educational(2)	EH JH Y UW K EY SH AH N AH L
educators	EH JH AH K EY T ER Z
educators(2)	EH JH Y UW K EY T ER Z
edward	EH D W ER D
effect	IH F EH K T
effect(2)	IY F EH K T
effect(3)	AH F EH K T
effective	IH F EH K T IH V
effective(2)	IY F EH K T IH V
effectively	IH F EH K T IH V L IY
effectively(2)	IY F EH K T IH V L IY
effectiveness	IH F EH K T IH V N AH S
effectiveness(2)	IY F EH K T IH V N AH S
efficiency	IH F IH SH AH N S IY
efficient	IH F IH SH AH N T
efficiently	IH F IH SH AH N T L IY
effort	EH F ER T
egypt	IY JH AH P T
egypt(2)	IY JH IH P T
egyptian	IH JH IH P SH AH N
eight	EY T
either	IY DH ER
either(2)	AY DH ER
ejaculation	IY JH AE K Y UW L EY SH AH N
elder	EH L D ER
elderly	EH L D ER L IY
elect	IH L EH K T
election	IH L EH K SH AH N
electoral	IH L EH K T ER AH L
electric	IH L EH K T R IH K
electrical	IH L EH K T R IH K AH L
electricity	IH L EH K T R IH S AH T IY
electro	IH L EH K T R OW
electron	IH L EH K T R AA N
electronic	IH L EH K T R AA N IH K
elegant	EH L AH G AH N T
element	EH L AH M AH N T
elementary	EH L AH M EH N T R IY
elementary(2)	EH L AH M EH N T ER R IY
elementary(3)	EH L AH M EH N CH R IY
elephant	EH L AH F AH N T
elevation	EH L AH V EY SH AH N
eleven	IH L EH V AH N
eleven(2)	IY L EH V AH N
eligibility	EH L IH JH AH B IH L IH T IY
eligible	EH L AH JH AH B AH L
eligible(2)	EH L IH JH AH B AH L
eliminate	IH L IH M AH N EY T
elimination	IH L IH M AH N EY SH AH N
elite	IH L IY T
elite(2)	EY L IY T
elizabeth	IH L IH Z AH B AH TH
elizabeth(2)	IH L IH Z AH B IH TH
ellen	EH L AH N
elliott	EH L IY AH T
ellis	EH L IH S
elsewhere	EH L S W EH R
elvis	EH L V IH S
emacs	EH M AH S
email	IY M EY L
embassy	EH M B AH S IY
embedded	EH M B EH D IH D
emerald	EH M R AH L D
emerald(2)	EH M ER R AH L D
emergency	IH M ER JH AH N S IY
emergency(2)	IY M ER JH AH N S IY
emerging	IH M ER JH IH NG
emerging(2)	IY M ER JH IH NG
emily	EH M IH L IY
eminem	IH M AH N EH M
emirates	EH M ER AH T S
emirates(2)	EH M ER EY T S
emission	IH M IH SH AH N
emotional	IH M OW SH AH N AH L
emotional(2)	IY M OW SH AH N AH L
emotions	IH M OW SH AH N Z
emperor	EH M P ER ER
emphasis	EH M F AH S IH S
empire	EH M P AY ER
empirical	EH M P IH R IH K AH L
employ	EH M P L OY
employ(2)	IH M P L OY
employment	EH M P L OY M AH N T
employment(2)	IH M P L OY M AH N T
empty	EH M P T IY
empty(2)	EH M T IY
enable	EH N EY B AH L
enable(2)	IH N EY B AH L
enabled	EH N EY B AH L D
enabled(2)	IH N EY B AH L D
enabling	EH N EY B AH L IH NG
enabling(2)	IH N EY B AH L IH NG
enabling(3)	IH N EY B L IH NG
enclosed	EH N K L OW Z D
enclosed(2)	IH N K L OW Z D
enclosure	EH N K L OW ZH ER
enclosure(2)	IH N K L OW ZH ER
encoding	EH N K OW D IH NG
encounter	IH N K AW N T ER
encounter(2)	IH N K AW N ER
encourage	EH N K ER IH JH
encourage(2)	IH N K ER AH JH
encouraged	EH N K ER IH JH D
encouraged(2)	IH N K ER AH JH D
encouraging	EH N K ER IH JH IH NG
encouraging(2)	IH N K ER AH JH IH NG
encryption	EH N K R IH P SH AH N
encyclopedia	IH N S AY K L AH P IY D IY AH
encyclopedia(2)	IH N S AY K L OW P IY D IY AH
endangered	EH N D EY N JH ER D
endangered(2)	IH N D EY N JH ER D
ended	EH N D AH D
ended(2)	EH N D IH D
endif	IH N D IH F
ending	EH N D IH NG
endless	EH N D L AH S
endorsed	EH N D AO R S T
endorsement	EH N D AO R S M AH N T
enemy	EH N AH M IY
energy	EH N ER JH IY
enforcement	EH N F AO R S M AH N T
engage	IH N G EY JH
engaged	IH N G EY JH D
engagement	EH N G EY JH M AH N T
engaging	IH N G EY JH IH NG
engine	EH N JH AH N
engine(2)	IH N JH AH N
engineer	EH N JH AH N IH R
engineering	EH N JH AH N IH R IH NG
england	IH NG G L AH N D
english	IH NG G L IH SH
english(2)	IH NG L IH SH
enhance	EH N HH AE N S
enhanced	EH N HH AE N S T
enhancement	EH N HH AE N S M AH N T
enhancing	EH N HH AE N S IH NG
enjoy	EH N JH OY
enjoying	EH N JH OY IH NG
enlarge	EH N L AA R JH
enlargement	EH N L AA R JH M AH N T
enormous	IH N AO R M AH S
enormous(2)	IH N AO R M IH S
enormous(3)	IY N AO R M AH S
enormous(4)	IY N AO R M IH S
enough	IH N AH F
enough(2)	IY N AH F
enquiry	IH N K W AY R IY
enrolled	EH N R OW L D
enrollment	EH N R OW L M AH N T
ensemble	AA N S AA M B AH L
ensure	EH N SH UH R
ensure(2)	IH N SH UH R
ensuring	EH N SH UH R IH NG
ensuring(2)	IH N SH UH R IH NG
enter	EH N T ER
enter(2)	EH N ER
entering	EH N T ER IH NG
entering(2)	EH N ER IH NG
enterprise	EH N T ER P R AY Z
enterprise(2)	EH N ER P R AY Z
entertaining	EH N T ER T EY N IH NG
entertaining(2)	EH N ER T EY N IH NG
entertainment	EH N T ER T EY N M AH N T
entertainment(2)	EH N ER T EY N M AH N T
entire	IH N T AY ER
entirely	IH N T AY ER L IY
entity	EH N T AH T IY
entity(2)	EH N T IH T IY
entrance	EH N T R AH N S
entrepreneur	AA N T R AH P R AH N ER
entrepreneur(2)	AA N T R AH P R AH N UH R
entry	EH N T R IY
envelope	EH N V AH L OW P
environment	IH N V AY R AH N M AH N T
environmental	IH N V AY R AH N M EH N T AH L
environmental(2)	IH N V AY R AH N M EH N AH L
enzyme	EH N Z AY M
epinions	AH P IH N IY AH N Z
episode	EH P IH S OW D
epson	EH P S AH N
equal	IY K W AH L
equality	IH K W AA L AH T IY
equally	IY K W AH L IY
equation	IH K W EY ZH AH N
equilibrium	IY K W AH L IH B R IY AH M
equipment	IH K W IH P M AH N T
equipped	IH K W IH P T
equity	EH K W AH T IY
equivalent	IH K W IH V AH L AH N T
ericsson	EH R IH K S AH N
erotic	IH R AA T IH K
erotica	IH R AA T IH K AH
error	EH R ER
escape	IH S K EY P
escort	EH S K AO R T
especially	AH S P EH SH L IY
especially(2)	AH S P EH SH AH L IY
essay	EH S EY
essence	EH S AH N S
essential	EH S EH N SH AH L
essential(2)	IY S EH N SH AH L
essentially	EH S EH N SH AH L IY
essentially(2)	IY S EH N SH AH L IY
essex	EH S IH K S
establish	IH S T AE B L IH SH
establishing	IH S T AE B L IH SH IH NG
establishment	IH S T AE B L IH SH M AH N T
estate	EH S T EY T
estimate	EH S T AH M AH T
estimate(2)	EH S T AH M EY T
estimated	EH S T AH M EY T AH D
estimated(2)	EH S T AH M EY T IH D
estimation	EH S T AH M EY SH AH N
estonia	EH S T OW N IY AH
eternal	IH T ER N AH L
eternal(2)	IY T ER N AH L
ethernet	IY TH ER N EH T
ethical	EH TH IH K AH L
ethics	EH TH IH K S
ethiopia	IY TH IY OW P IY AH
ethnic	EH TH N IH K
eugene	Y UW JH IY N
europe	Y UH R AH P
european	Y UH R AH P IY AH N
euros	Y UW R OW Z
evaluate	IH V AE L Y UW EY T
evaluate(2)	IY V AE L Y UW EY T
evaluated	IH V AE L Y UW EY T AH D
evaluated(2)	IY V AE L Y UW EY T AH D
evaluating	IH V AE L Y UW EY T IH NG
evaluating(2)	IY V AE L Y UW EY T IH NG
evaluation	IH V AE L Y UW EY SH AH N
evaluation(2)	IY V AE L Y UW EY SH AH N
evanescence	EH V AH N EH S AH N S
evans	EH V AH N Z
evening	IY V N IH NG
event	IH V EH N T
event(2)	IY V EH N T
eventually	IH V EH N CH AH W AH L IY
eventually(2)	IH V EH N SH AH L IY
eventually(3)	IY V EH N CH AH W AH L IY
eventually(4)	IY V EH N SH AH L IY
every	EH V ER IY
every(2)	EH V R IY
everybody	EH V R IY B AA D IY
everyday	EH V R IY D EY
everyone	EH V R IY W AH N
everything	EH V R IY TH IH NG
everywhere	EH V R IY W EH R
everywhere(2)	EH V R IY HH W EH R
evidence	EH V AH D AH N S
evident	EH V AH D AH N T
evolution	EH V AH L UW SH AH N
evolution(2)	IY V AH L UW SH AH N
evolution(3)	EH V OW L UW SH AH N
evolution(4)	IY V OW L UW SH AH N
exact	IH G Z AE K T
exactly	IH G Z AE K T L IY
examination	IH G Z AE M AH N EY SH AH N
examine	IH G Z AE M IH N
examined	IH G Z AE M AH N D
examining	IH G Z AE M IH N IH NG
example	IH G Z AE M P AH L
exams	IH G Z AE M Z
exceed	IH K S IY D
excel	IH K S EH L
excellence	EH K S AH L AH N S
excellent	EH K S AH L AH N T
except	IH K S EH P T
exception	IH K S EH P SH AH N
exceptional	IH K S EH P SH AH N AH L
excerpt	EH K S ER P T
excess	EH K S EH S
excess(2)	IH K S EH S
excessive	IH K S EH S IH V
exchange	IH K S CH EY N JH
excited	IH K S AY T AH D
excited(2)	IH K S AY T IH D
excitement	IH K S AY T M AH N T
exciting	IH K S AY T IH NG
exclude	IH K S K L UW D
excluded	IH K S K L UW D AH D
excluded(2)	IH K S K L UW D IH D
excluding	IH K S K L UW D IH NG
exclusion	IH K S K L UW ZH AH N
exclusive	IH K S K L UW S IH V
exclusively	IH K S K L UW S IH V L IY
excuse	IH K S K Y UW S
excuse(2)	IH K S K Y UW Z
execute	EH K S AH K Y UW T
executed	EH K S AH K Y UW T IH D
execution	EH K S AH K Y UW SH AH N
executive	IH G Z EH K Y AH T IH V
exempt	IH G Z EH M P T
exemption	IH G Z EH M P SH AH N
exercise	EH K S ER S AY Z
exhaust	IH G Z AO S T
exhibit	IH G Z IH B IH T
exhibition	EH K S AH B IH SH AH N
exist	IH G Z IH S T
existence	EH G Z IH S T AH N S
existence(2)	IH G Z IH S T AH N S
existing	IH G Z IH S T IH NG
exotic	IH G Z AA T IH K
expand	IH K S P AE N D
expanding	IH K S P AE N D IH NG
expansion	IH K S P AE N SH AH N
expansion(2)	IH K S P AE N CH AH N
expansys	EH K S P AE N Z IY Z
expect	IH K S P EH K T
expectations	EH K S P EH K T EY SH AH N Z
expedia	EH K S P IY D IY AH
expenditure	IH K S P EH N D AH CH ER
expenditure(2)	IH K S P EH N D IH CH ER
expense	IH K S P EH N S
expensive	IH K S P EH N S IH V
experience	IH K S P IH R IY AH N S
experienced	IH K S P IH R IY AH N S T
experiencing	IH K S P IH R IY AH N S IH NG
experiment	IH K S P EH R AH M AH N T
experimental	IH K S P EH R IH M EH N T AH L
expert	EH K S P ER T
expertise	EH K S P ER T IY Z
expiration	EH K S P ER EY SH AH N
expired	IH K S P AY R D
expires	IH K S P AY ER Z
explain	IH K S P L EY N
explaining	IH K S P L EY N IH NG
explanation	EH K S P L AH N EY SH AH N
explicit	IH K S P L IH S AH T
explicitly	IH K S P L IH S AH T L IY
exploration	EH K S P L ER EY SH AH N
exploration(2)	EH K S P L AO R EY SH AH N
explore	IH K S P L AO R
explorer	IH K S P L AO R ER
exploring	IH K S P L AO R IH NG
explosion	IH K S P L OW ZH AH N
export	EH K S P AO R T
exposed	IH K S P OW Z D
exposure	IH K S P OW ZH ER
express	IH K S P R EH S
expression	IH K S P R EH SH AH N
extend	IH K S T EH N D
extending	IH K S T EH N D IH NG
extension	IH K S T EH N SH AH N
extensive	IH K S T EH N S IH V
extent	IH K S T EH N T
exterior	IH K S T IH R IY ER
external	IH K S T ER N AH L
extra	EH K S T R AH
extract	EH K S T R AE K T
extract(2)	IH K S T R AE K T
extraction	EH K S T R AE K SH AH N
extraordinary	EH K S T R AH AO R D AH N EH R IY
extraordinary(2)	IH K S T R AO R D AH N EH R IY
extreme	IH K S T R IY M
extremely	IH K S T R IY M L IY
fabric	F AE B R IH K
fabulous	F AE B Y AH L AH S
faced	F EY S T
faces	F EY S AH Z
faces(2)	F EY S IH Z
facial	F EY SH AH L
facility	F AH S IH L IH T IY
facing	F EY S IH NG
factor	F AE K T ER
factory	F AE K T ER IY
facts	F AE K T S
facts(2)	F AE K S
faculty	F AE K AH L T IY
failed	F EY L D
failing	F EY L IH NG
fails	F EY L Z
failure	F EY L Y ER
fairfield	F EH R F IY L D
fairly	F EH R L IY
fairy	F EH R IY
faith	F EY TH
fallen	F AA L AH N
falling	F AA L IH NG
falls	F AO L Z
false	F AO L S
family	F AE M AH L IY
family(2)	F AE M L IY
famous	F EY M AH S
fancy	F AE N S IY
fantasy	F AE N T AH S IY
fantasy(2)	F AE N AH S IY
fares	F EH R Z
farmer	F AA R M ER
farming	F AA R M IH NG
farms	F AA R M Z
fascinating	F AE S AH N EY T IH NG
fashion	F AE SH AH N
faster	F AE S T ER
fastest	F AE S T AH S T
fatal	F EY T AH L
father	F AA DH ER
fatty	F AE T IY
fault	F AO L T
favor	F EY V ER
favorite	F EY V ER IH T
favorite(2)	F EY V R AH T
favour	F EY V ER
favourite	F EY V ER IH T
fears	F IH R Z
feature	F IY CH ER
featured	F IY CH ER D
featuring	F IY CH ER IH NG
february	F EH B Y AH W EH R IY
february(2)	F EH B R UW EH R IY
federal	F EH D ER AH L
federal(2)	F EH D R AH L
federation	F EH D ER EY SH AH N
feedback	F IY D B AE K
feeding	F IY D IH NG
feeds	F IY D Z
feeling	F IY L IH NG
feels	F IY L Z
fellow	F EH L OW
fellowship	F EH L OW SH IH P
female	F IY M EY L
fence	F EH N S
ferry	F EH R IY
festival	F EH S T AH V AH L
festival(2)	F EH S T IH V AH L
fetish	F EH T IH SH
fever	F IY V ER
fewer	F Y UW ER
fiber	F AY B ER
fibre	F AY B ER
fiction	F IH K SH AH N
field	F IY L D
fifth	F IH F TH
fifth(2)	F IH TH
fifty	F IH F T IY
fight	F AY T
fighter	F AY T ER
fighting	F AY T IH NG
figure	F IH G Y ER
figured	F IH G Y ER D
filed	F AY L D
filename	F AY L N EY M
files	F AY L Z
filing	F AY L IH NG
filled	F IH L D
filling	F IH L IH NG
filme	F IH L M
films	F IH L M Z
filter	F IH L T ER
filtering	F IH L T ER IH NG
final	F AY N AH L
finally	F AY N AH L IY
finance	F AH N AE N S
finance(2)	F IH N AE N S
finance(3)	F AY N AE N S
financial	F AH N AE N SH AH L
financial(2)	F IH N AE N SH AH L
financial(3)	F AY N AE N SH AH L
financing	F AH N AE N S IH NG
financing(2)	F IH N AE N S IH NG
financing(3)	F AY N AE N S IH NG
findarticles	F AY N D AA R T IH K AH L Z
finder	F AY N D ER
finding	F AY N D IH NG
findlaw	F AY N D L AO
finds	F AY N D Z
finest	F AY N AH S T
finger	F IH NG G ER
fingering	F IH NG G ER IH NG
finish	F IH N IH SH
finishing	F IH N IH SH IH NG
finite	F AY N AY T
finland	F IH N L AE N D
finland(2)	F IH N L AH N D
finnish	F IH N IH SH
fioricet	F AY AO R AH S AH T
fired	F AY ER D
firefox	F AY ER F AA K S
fireplace	F AY ER P L EY S
fires	F AY ER Z
fires(2)	F AY R Z
firewall	F AY R W AA L
firewire	F AY ER W AY ER
firms	F ER M Z
firmware	F ER M W EH R
first	F ER S T
fiscal	F IH S K AH L
fisher	F IH SH ER
fisheries	F IH SH ER IY Z
fishing	F IH SH IH NG
fisting	F IH S T IH NG
fitness	F IH T N AH S
fitted	F IH T AH D
fitted(2)	F IH T IH D
fitting	F IH T IH NG
fixed	F IH K S T
fixes	F IH K S IH Z
fixtures	F IH K S CH ER Z
flashers	F L AE SH ER Z
flashing	F L AE SH IH NG
flavor	F L EY V ER
fleece	F L IY S
flexibility	F L EH K S AH B IH L AH T IY
flexible	F L EH K S AH B AH L
flickr	F L IH K ER
flight	F L AY T
floating	F L OW T IH NG
flooring	F L AO R IH NG
floppy	F L AA P IY
floral	F L AO R AH L
florence	F L AO R AH N S
florida	F L AO R AH D AH
florida(2)	F L AO R IH D AH
florida(3)	F L AA R AH D AH
florida(4)	F L AA R IH D AH
florist	F L AA R IH S T
florist(2)	F L AO R IH S T
flower	F L AW ER
flying	F L AY IH NG
focal	F OW K AH L
focus	F OW K AH S
focus(2)	F OW K IH S
focusing	F OW K AH S IH NG
focusing(2)	F OW K IH S IH NG
folder	F OW L D ER
folding	F OW L D IH NG
folks	F OW K S
follow	F AA L OW
following	F AA L OW IH NG
fonts	F AA N T S
foods	F UW D Z
footage	F UH T IH JH
football	F UH T B AO L
footwear	F UH T W EH R
forbes	F AO R B Z
forbidden	F AO R B IH D AH N
forbidden(2)	F ER R B IH D AH N
force	F AO R S
forced	F AO R S T
forecast	F AO R K AE S T
foreign	F AO R AH N
foreign(2)	F AA R AH N
forest	F AO R AH S T
forest(2)	F AO R IH S T
forestry	F AO R AH S T R IY
forever	F ER EH V ER
forge	F AO R JH
forget	F ER G EH T
forget(2)	F AO R G EH T
forgot	F ER G AA T
forgot(2)	F AO R G AA T
forgotten	F ER G AA T AH N
forgotten(2)	F AO R G AA T AH N
formal	F AO R M AH L
format	F AO R M AE T
formation	F AO R M EY SH AH N
formatting	F AO R M AE T IH NG
formed	F AO R M D
former	F AO R M ER
formerly	F AO R M ER L IY
forming	F AO R M IH NG
forms	F AO R M Z
formula	F AO R M Y AH L AH
forth	F AO R TH
forty	F AO R T IY
forum	F AO R AH M
forward	F AO R W ER D
forwarding	F AO R W ER D IH NG
fossil	F AA S AH L
foster	F AA S T ER
fotos	F AA T AH Z
fought	F AO T
found	F AW N D
foundation	F AW N D EY SH AH N
founder	F AW N D ER
fountain	F AW N T AH N
fourth	F AO R TH
fraction	F R AE K SH AH N
fragrance	F R EY G R AH N S
frame	F R EY M
framed	F R EY M D
framework	F R EY M W ER K
framing	F R EY M IH NG
france	F R AE N S
franchise	F R AE N CH AY Z
francis	F R AE N S AH S
francis(2)	F R AE N S IH S
francisco	F R AE N S IH S K OW
frank	F R AE NG K
frankfurt	F R AE NG K F ER T
franklin	F R AE NG K L IH N
fraser	F R EY Z ER
fraud	F R AO D
frederick	F R EH D R IH K
frederick(2)	F R EH D ER IH K
freebsd	F R IY B S D
freedom	F R IY D AH M
freelance	F R IY L AE N S
freely	F R IY L IY
freeware	F R IY W EH R
freeze	F R IY Z
freight	F R EY T
french	F R EH N CH
frequency	F R IY K W AH N S IY
frequent	F R IY K W AH N T
frequent(2)	F R IY K W EH N T
frequently	F R IY K W AH N T L IY
frequently(2)	F R IY K W EH N T L IY
fresh	F R EH SH
friday	F R AY D IY
friday(2)	F R AY D EY
fridge	F R IH JH
friend	F R EH N D
friendly	F R EH N D L IY
friendship	F R EH N D SH IH P
front	F R AH N T
frontier	F R AH N T IH R
frontpage	F R AH N T P EY JH
frost	F R AO S T
frozen	F R OW Z AH N
fruit	F R UW T
fucked	F AH K T
fucking	F AH K IH NG
fujitsu	F UW JH IH T S UW
fully	F UH L IY
function	F AH NG K SH AH N
functional	F AH NG K SH AH N AH L
functionality	F AH NG K SH AH N AE L IH T IY
functioning	F AH NG K SH AH N IH NG
fundamental	F AH N D AH M EH N T AH L
fundamental(2)	F AH N D AH M EH N AH L
funded	F AH N D AH D
funded(2)	F AH N D IH D
funding	F AH N D IH NG
fundraising	F AH N D R EY S IH NG
funds	F AH N D Z
funeral	F Y UW N ER AH L
funky	F AH NG K IY
funny	F AH N IY
furnished	F ER N IH SH T
furnishings	F ER N IH SH IH NG Z
furniture	F ER N IH CH ER
further	F ER DH ER
furthermore	F ER DH ER M AO R
fusion	F Y UW ZH AH N
future	F Y UW CH ER
fuzzy	F AH Z IY
gabriel	G EY B R IY AH L
gadgets	G AE JH AH T S
gained	G EY N D
galaxy	G AE L AH K S IY
gallery	G AE L ER IY
gambling	G AE M B AH L IH NG
gambling(2)	G AE M B L IH NG
gamecube	G EY M K Y UW B
gamespot	G EY M S P AA T
gaming	G EY M IH NG
gangbang	G AE NG B AE NG
garbage	G AA R B IH JH
gardening	G AA R D AH N IH NG
gardening(2)	G AA R D N IH NG
gasoline	G AE S AH L IY N
gateway	G EY T W EY
gather	G AE DH ER
gathering	G AE DH ER IH NG
gazette	G AH Z EH T
gender	JH EH N D ER
genealogy	JH IY N IY AA L AH JH IY
general	JH EH N ER AH L
general(2)	JH EH N R AH L
generally	JH EH N ER AH L IY
generally(2)	JH EH N R AH L IY
generate	JH EH N ER EY T
generated	JH EH N ER EY T AH D
generated(2)	JH EH N ER EY T IH D
generating	JH EH N ER EY T IH NG
generation	JH EH N ER EY SH AH N
generator	JH EH N ER EY T ER
generic	JH AH N EH R IH K
generous	JH EH N ER AH S
genes	JH IY N Z
genesis	JH EH N AH S AH S
genetic	JH AH N EH T IH K
geneva	JH AH N IY V AH
genius	JH IY N Y AH S
genome	JH IY N OW M
genre	ZH AA N R AH
gentle	JH EH N T AH L
gentle(2)	JH EH N AH L
gentleman	JH EH N T AH L M AH N
gentleman(2)	JH EH N AH L M AH N
gently	JH EH N T L IY
genuine	JH EH N Y UW AH N
genuine(2)	JH EH N Y UW AY N
geographic	JH IY AH G R AE F IH K
geographical	JH IY AH G R AE F IH K AH L
geography	JH IY AA G R AH F IY
geological	JH IY AH L AA JH IH K AH L
geology	JH IY AA L AH JH IY
geometry	JH IY AA M AH T R IY
george	JH AO R JH
georgia	JH AO R JH AH
gerald	JH EH R AH L D
german	JH ER M AH N
germany	JH ER M AH N IY
getting	G EH T IH NG
getting(2)	G IH T IH NG
ghana	G AE N AH
ghost	G OW S T
giant	JH AY AH N T
gibraltar	JH IH B R AO L T ER
gibson	G IH B S AH N
gifts	G IH F T S
gifts(2)	G IH F S
gilbert	G IH L B ER T
girlfriend	G ER L F R EH N D
girls	G ER L Z
given	G IH V AH N
given(2)	G IH V IH N
gives	G IH V Z
giving	G IH V IH NG
glance	G L AE N S
glasgow	G L AE S K OW
glasgow(2)	G L AE S G OW
glass	G L AE S
glenn	G L EH N
global	G L OW B AH L
globe	G L OW B
glory	G L AO R IY
glossary	G L AO S ER IY
gloves	G L AH V Z
glucose	G L UW K OW S
gnome	N OW M
goals	G OW L Z
going	G OW IH NG
going(2)	G OW IH N
golden	G OW L D AH N
gonna	G AA N AH
goods	G UH D Z
google	G UW G AH L
gordon	G AO R D AH N
gorgeous	G AO R JH AH S
gospel	G AA S P AH L
gospel(2)	G AO S P AH L
gossip	G AA S AH P
gothic	G AA TH IH K
gotta	G AA T AH
gotten	G AA T AH N
gotten(2)	G AO T AH N
gourmet	G UH R M EY
governance	G AH V ER N AH N S
governing	G AH V ER N IH NG
government	G AH V ER N M AH N T
governmental	G AH V ER M EH N T AH L
governmental(2)	G AH V ER N M EH N T AH L
governor	G AH V ER N ER
grace	G R EY S
grade	G R EY D
gradually	G R AE JH UW AH L IY
gradually(2)	G R AE JH UW L IY
graduate	G R AE JH AH W AH T
graduate(2)	G R AE JH AH W EY T
graduate(3)	G R AE JH UW W AH T
graduate(4)	G R AE JH UW EY T
graduated	G R AE JH UW EY T IH D
graduated(2)	G R AE JH AH W EY T IH D
graduation	G R AE JH UW EY SH AH N
graduation(2)	G R AE JH AH W EY SH AH N
grain	G R EY N
grammar	G R AE M ER
grams	G R AE M Z
grand	G R AE N D
grant	G R AE N T
graph	G R AE F
graphic	G R AE F IH K
graphical	G R AE F IH K AH L
grass	G R AE S
grateful	G R EY T F AH L
gratuit	G R AH T UW T
grave	G R EY V
gravity	G R AE V AH T IY
gravity(2)	G R AE V IH T IY
great	G R EY T
greater	G R EY T ER
greatest	G R EY T AH S T
greatly	G R EY T L IY
greek	G R IY K
green	G R IY N
greenhouse	G R IY N HH AW S
greensboro	G R IY N Z B ER R OW
greeting	G R IY T IH NG
gregory	G R EH G ER IY
grenada	G R IH N EY D AH
grenada(2)	G R IH N AA D AH
griffin	G R IH F IH N
grill	G R IH L
grocery	G R OW S ER IY
grocery(2)	G R OW S R IY
groove	G R UW V
gross	G R OW S
ground	G R AW N D
groundwater	G R AW N D W AA T ER
groundwater(2)	G R AW N D W AO T ER
group	G R UW P
grove	G R OW V
growing	G R OW IH NG
grown	G R OW N
grows	G R OW Z
growth	G R OW TH
guarantee	G EH R AH N T IY
guaranteed	G EH R AH N T IY D
guardian	G AA R D IY AH N
guatemala	G W AA T AH M AA L AH
guestbook	G EH S T B UH K
guidance	G AY D AH N S
guided	G AY D AH D
guided(2)	G AY D IH D
guidelines	G AY D L AY N Z
guilty	G IH L T IY
guinea	G IH N IY
guitar	G IH T AA R
guyana	G AY AA N AH
habitat	HH AE B AH T AE T
habits	HH AE B AH T S
hacker	HH AE K ER
halifax	HH AE L IH F AE K S
halloween	HH AE L AH W IY N
hamburg	HH AE M B ER G
hamilton	HH AE M AH L T AH N
hammer	HH AE M ER
hampshire	HH AE M P SH ER
hampshire(2)	HH AE M SH ER
hampshire(3)	HH AE M P SH AY ER
hampshire(4)	HH AE M SH AY ER
hampton	HH AE M P T AH N
handbags	HH AE N D B AE G Z
handbook	HH AE N D B UH K
handed	HH AE N D AH D
handed(2)	HH AE N D IH D
handheld	HH AE N D HH EH L D
handle	HH AE N D AH L
handling	HH AE N D L IH NG
handling(2)	HH AE N D AH L IH NG
handmade	HH AE N D M EY D
handmade(2)	HH AE N M EY D
hanging	HH AE NG IH NG
hanging(2)	HH AE NG G IH NG
hansen	HH AE N S AH N
happen	HH AE P AH N
happening	HH AE P AH N IH NG
happening(2)	HH AE P N IH NG
happiness	HH AE P IY N AH S
harassment	HH ER AE S M AH N T
harbor	HH AA R B ER
harbour	HH AA R B ER
hardcore	HH AA R D K AO R
hardcover	HH AA R D K AH V ER
harder	HH AA R D ER
hardly	HH AA R D L IY
hardware	HH AA R D W EH R
hardwood	HH AA R D W UH D
harley	HH AA R L IY
harmful	HH AA R M F AH L
harmony	HH AA R M AH N IY
harold	HH EH R AH L D
harper	HH AA R P ER
harris	HH EH R IH S
harrison	HH EH R IH S AH N
hartford	HH AA R T F ER D
harvard	HH AA R V ER D
harvest	HH AA R V AH S T
harvey	HH AA R V IY
having	HH AE V IH NG
hawaii	HH AH W AY IY
hawaiian	HH AH W AY AH N
hazard	HH AE Z ER D
hazardous	HH AE Z ER D AH S
headed	HH EH D AH D
headed(2)	HH EH D IH D
header	HH EH D ER
heading	HH EH D IH NG
headline	HH EH D L AY N
headphones	HH EH D F OW N Z
headquarters	HH EH D K W AO R T ER Z
headquarters(2)	HH EH D K AO R T ER Z
headset	HH EH D S EH T
healing	HH IY L IH NG
health	HH EH L TH
healthcare	HH EH L TH K EH R
healthy	HH EH L TH IY
hearing	HH IY R IH NG
heated	HH IY T AH D
heated(2)	HH IY T IH D
heater	HH IY T ER
heather	HH EH DH ER
heating	HH IY T IH NG
heaven	HH EH V AH N
hebrew	HH IY B R UW
height	HH AY T
helena	HH EH L AH N AH
helicopter	HH EH L IH K AA P T ER
helmet	HH EH L M AH T
helped	HH EH L P T
helpful	HH EH L P F AH L
helping	HH EH L P IH NG
henderson	HH EH N D ER S AH N
hentai	HH EH N T EY
hepatitis	HH EH P AH T AY T AH S
herald	HH EH R AH L D
herbal	ER B AH L
herbal(2)	HH ER B AH L
hereby	HH IH R B AY
herein	HH IH R IH N
heritage	HH EH R AH T AH JH
heritage(2)	HH EH R IH T IH JH
heroes	HH IH R OW Z
heroes(2)	HH IY R OW Z
herself	HH ER S EH L F
hewlett	HH Y UW L IH T
hidden	HH IH D AH N
hierarchy	HH AY ER AA R K IY
hierarchy(2)	HH AY R AA R K IY
higher	HH AY ER
highest	HH AY AH S T
highlight	HH AY L AY T
highly	HH AY L IY
highs	HH AY Z
highway	HH AY W EY
hiking	HH AY K IH NG
hills	HH IH L Z
hilton	HH IH L T AH N
himself	HH IH M S EH L F
hindu	HH IH N D UW
hints	HH IH N T S
hired	HH AY ER D
hiring	HH AY R IH NG
hispanic	HH IH S P AE N IH K
historic	HH IH S T AO R IH K
historical	HH IH S T AO R IH K AH L
history	HH IH S T ER IY
history(2)	HH IH S T R IY
hitachi	HH IH T AA CH IY
hitting	HH IH T IH NG
hobby	HH AA B IY
hockey	HH AA K IY
holding	HH OW L D IH NG
holds	HH OW L D Z
holes	HH OW L Z
holiday	HH AA L AH D EY
holiday(2)	HH AA L IH D EY
holly	HH AA L IY
hollywood	HH AA L IY W UH D
holocaust	HH AO L AH K AO S T
homeland	HH OW M L AE N D
homeless	HH OW M L AH S
homepage	HH OW M P EY JH
homes	HH OW M Z
hometown	HH OW M T AW N
homework	HH OW M W ER K
honda	HH AO N D AH
honduras	HH AA N D UH R AH S
honest	AA N AH S T
honey	HH AH N IY
honolulu	HH AA N AH L UW L UW
honor	AA N ER
hoped	HH OW P T
hopefully	HH OW P F AH L IY
hopes	HH OW P S
hoping	HH OW P IH NG
hopkins	HH AA P K IH N Z
horizon	HH ER AY Z AH N
horizontal	HH AO R AH Z AA N T AH L
hormone	HH AO R M OW N
horny	HH AO R N IY
horrible	HH AO R AH B AH L
horror	HH AO R ER
horse	HH AO R S
hospital	HH AA S P IH T AH L
hospitality	HH AA S P AH T AE L AH T IY
hosted	HH OW S T IH D
hostel	HH AA S T AH L
hosting	HH OW S T IH NG
hosts	HH OW S T S
hotel	HH OW T EH L
hotmail	HH AA T M EY L
hottest	HH AA T AH S T
hourly	AW R L IY
hours	AW ER Z
hours(2)	AW R Z
house	HH AW S
household	HH AW S HH OW L D
housewares	HH AW S W EH R Z
housewives	HH AW S W AY V Z
housing	HH AW Z IH NG
houston	HH Y UW S T AH N
howard	HH AW ER D
however	HH AW EH V ER
howto	HH OW T OW
hudson	HH AH D S AH N
hughes	HH Y UW Z
hughes(2)	Y UW Z
human	HH Y UW M AH N
human(2)	Y UW M AH N
humanitarian	HH Y UW M AE N AH T EH R IY AH N
humanitarian(2)	Y UW M AE N AH T EH R IY AH N
humanity	HH Y UW M AE N IH T IY
humanity(2)	Y UW M AE N IH T IY
humidity	HH Y UW M IH D AH T IY
humor	HH Y UW M ER
hundred	HH AH N D R AH D
hundred(2)	HH AH N D R IH D
hundred(3)	HH AH N ER D
hundred(4)	HH AH N D ER D
hungary	HH AH NG G ER IY
hunger	HH AH NG G ER
hungry	HH AH NG G R IY
hunter	HH AH N T ER
hunting	HH AH N T IH NG
huntington	HH AH N T IH NG T AH N
hurricane	HH ER AH K EY N
hurricane(2)	HH AH R AH K EY N Z
husband	HH AH Z B AH N D
hybrid	HH AY B R AH D
hybrid(2)	HH AY B R IH D
hydraulic	HH AY D R AO L IH K
hydrocodone	HH IH D R AA K AH D OW N
hydrogen	HH AY D R AH JH AH N
hygiene	HH AY JH IY N
hypothesis	HH AY P AA TH AH S AH S
hypothetical	HH AY P AH TH EH T AH K AH L
hypothetical(2)	HH AY P AH TH EH T IH K AH L
hyundai	HH Y AH N D EY
hyundai(2)	HH AH N D EY
iceland	AY S L AH N D
icons	AY K AA N Z
idaho	AY D AH HH OW
ideal	AY D IY L
ideas	AY D IY AH Z
identical	AY D EH N T IH K AH L
identification	AY D EH N T AH F AH K EY SH AH N
identify	AY D EH N T AH F AY
identifying	AY D EH N T AH F AY IH NG
identity	AY D EH N T AH T IY
ignore	IH G N AO R
ignored	IH G N AO R D
illegal	IH L IY G AH L
illinois	IH L AH N OY
illinois(2)	IH L AH N OY Z
illness	IH L N AH S
illustrated	IH L AH S T R EY T AH D
illustrated(2)	IH L AH S T R EY T IH D
illustration	IH L AH S T R EY SH AH N
image	IH M AH JH
image(2)	IH M IH JH
imagination	IH M AE JH AH N EY SH AH N
imagine	IH M AE JH AH N
imaging	IH M IH JH IH NG
immediate	IH M IY D IY AH T
immediately	IH M IY D IY AH T L IY
immigrants	IH M AH G R AH N T S
immigration	IH M AH G R EY SH AH N
immune	IH M Y UW N
immunology	IH M Y UW N AA L AH JH IY
impact	IH M P AE K T
impaired	IH M P EH R D
imperial	IH M P IH R IY AH L
implement	IH M P L AH M AH N T
implementation	IH M P L AH M EH N T EY SH AH N
implementing	IH M P L AH M EH N T IH NG
implementing(2)	IH M P L AH M EH N IH NG
implications	IH M P L AH K EY SH AH N Z
implied	IH M P L AY D
implies	IH M P L AY Z
import	IH M P AO R T
importance	IH M P AO R T AH N S
important	IH M P AO R T AH N T
importantly	IH M P AO R T AH N T L IY
impose	IH M P OW Z
imposed	IH M P OW Z D
impossible	IH M P AA S AH B AH L
impressed	IH M P R EH S T
impression	IH M P R EH SH AH N
impressive	IH M P R EH S IH V
improve	IH M P R UW V
improved	IH M P R UW V D
improvement	IH M P R UW V M AH N T
improving	IH M P R UW V IH NG
inappropriate	IH N AH P R OW P R IY IH T
inbox	IH N B AA K S
incentive	IH N S EH N T IH V
incentive(2)	IH N S EH N IH V
incest	IH N S EH S T
inches	IH N CH AH Z
inches(2)	IH N CH IH Z
incidence	IH N S AH D AH N S
incidence(2)	IH N S IH D AH N S
incident	IH N S AH D AH N T
include	IH N K L UW D
included	IH N K L UW D AH D
included(2)	IH N K L UW D IH D
including	IH N K L UW D IH NG
inclusion	IH N K L UW ZH AH N
inclusive	IH N K L UW S IH V
income	IH N K AH M
incoming	IH N K AH M IH NG
incomplete	IH N K AH M P L IY T
incorporate	IH N K AO R P ER EY T
incorporated	IH N K AO R P ER EY T IH D
incorrect	IH N K ER EH K T
increase	IH N K R IY S
increased	IH N K R IY S T
increasing	IH N K R IY S IH NG
increasingly	IH N K R IY S IH NG G L IY
incredible	IH N K R EH D AH B AH L
incurred	IH N K ER D
indeed	IH N D IY D
independence	IH N D IH P EH N D AH N S
independent	IH N D IH P EH N D AH N T
independently	IH N D IH P EH N D AH N T L IY
index	IH N D EH K S
india	IH N D IY AH
indian	IH N D IY AH N
indiana	IH N D IY AE N AH
indianapolis	IH N D IY AH N AE P AH L IH S
indicate	IH N D AH K EY T
indicated	IH N D AH K EY T AH D
indicated(2)	IH N D AH K EY T IH D
indicating	IH N D AH K EY T IH NG
indication	IH N D AH K EY SH AH N
indicator	IH N D AH K EY T ER
indices	IH N D IH S IY Z
indices(2)	IH N D AH S IH Z
indie	IH N D IY
indigenous	IH N D IH JH AH N AH S
indirect	IH N D ER EH K T
individual	IH N D AH V IH JH AH W AH L
individually	IH N D IH V IH JH UW AH L IY
individually(2)	IH N D IH V IH JH AH L IY
indonesia	IH N D OW N IY ZH AH
indonesian	IH N D OW N IY ZH AH N
indoor	IH N D AO R
induced	IH N D UW S T
induction	IH N D AH K SH AH N
industry	IH N D AH S T R IY
inexpensive	IH N IH K S P EH N S IH V
infant	IH N F AH N T
infected	IH N F EH K T IH D
infection	IH N F EH K SH AH N
infectious	IH N F EH K SH AH S
infinite	IH N F AH N AH T
inflation	IH N F L EY SH AH N
influence	IH N F L UW AH N S
influenced	IH N F L UW AH N S T
inform	IH N F AO R M
informal	IH N F AO R M AH L
information	IH N F AO R M EY SH AH N
informational	IH N F AO R M EY SH AH N AH L
informative	IH N F AO R M AH T IH V
infrared	IH N F R ER EH D
infrastructure	IH N F R AH S T R AH K CH ER
infringement	IH N F R IH N JH M AH N T
ingredients	IH N G R IY D IY AH N T S
inherited	IH N HH EH R AH T IH D
initial	IH N IH SH AH L
initially	IH N IH SH AH L IY
initiated	IH N IH SH IY EY T AH D
initiated(2)	IH N IH SH IY EY T IH D
initiative	IH N IH SH AH T IH V
initiative(2)	IH N IH SH Y AH T IH V
injection	IH N JH EH K SH AH N
injured	IH N JH ER D
injury	IH N JH ER IY
inkjet	IH NG K JH EH T
inline	IH N L AY N
inner	IH N ER
innocent	IH N AH S AH N T
innovation	IH N AH V EY SH AH N
innovation(2)	IH N OW V EY SH AH N
innovative	IH N AH V EY T IH V
innovative(2)	IH N OW V EY T IH V
input	IH N P UH T
inquire	IH N K W AY R
inquiry	IH N K W AY R IY
inquiry(2)	IH N K W AH R IY
insects	IH N S EH K T S
insert	IH N S ER T
insertion	IH N S ER SH AH N
inside	IH N S AY D
insider	IH N S AY D ER
insight	IH N S AY T
inspection	IH N S P EH K SH AH N
inspector	IH N S P EH K T ER
inspiration	IH N S P ER EY SH AH N
inspired	IH N S P AY ER D
install	IH N S T AO L
installation	IH N S T AH L EY SH AH N
installing	IH N S T AO L IH NG
instance	IH N S T AH N S
instant	IH N S T AH N T
instantly	IH N S T AH N T L IY
instead	IH N S T EH D
institute	IH N S T IH T UW T
institution	IH N S T IH T UW SH AH N
institutional	IH N S T IH T UW SH AH N AH L
instruction	IH N S T R AH K SH AH N
instructional	IH N S T R AH K SH AH N AH L
instructor	IH N S T R AH K T ER
instrument	IH N S T R AH M AH N T
instrumental	IH N S T R AH M EH N T AH L
instrumental(2)	IH N S T R AH M EH N AH L
instrumentation	IH N S T R AH M EH N T EY SH AH N
insulation	IH N S AH L EY SH AH N
insulin	IH N S AH L AH N
insurance	IH N SH UH R AH N S
insured	IH N SH UH R D
intake	IH N T EY K
integer	IH N T AH JH ER
integral	IH N T AH G R AH L
integral(2)	IH N AH G R AH L
integrate	IH N T AH G R EY T
integrate(2)	IH N AH G R EY T
integrated	IH N T AH G R EY T AH D
integrated(2)	IH N T AH G R EY T IH D
integrated(3)	IH N AH G R EY T AH D
integrated(4)	IH N AH G R EY T IH D
integrating	IH N T AH G R EY T IH NG
integrating(2)	IH N AH G R EY T IH NG
integration	IH N T AH G R EY SH AH N
integration(2)	IH N AH G R EY SH AH N
integrity	IH N T EH G R AH T IY
intel	IH N T EH L
intellectual	IH N T AH L EH K CH UW AH L
intellectual(2)	IH N AH L EH K CH UW AH L
intelligence	IH N T EH L AH JH AH N S
intelligent	IH N T EH L AH JH AH N T
intend	IH N T EH N D
intense	IH N T EH N S
intensity	IH N T EH N S IH T IY
intensive	IH N T EH N S IH V
intent	IH N T EH N T
intention	IH N T EH N CH AH N
inter	IH N T ER
interact	IH N T ER AE K T
interact(2)	IH N ER AE K T
interaction	IH N T ER AE K SH AH N
interaction(2)	IH N ER AE K SH AH N
interactive	IH N T ER AE K T IH V
interactive(2)	IH N ER AE K T IH V
interest	IH N T AH R EH S T
interesting	IH N T AH R EH S T IH NG
interface	IH N T ER F EY S
interface(2)	IH N ER F EY S
interference	IH N T ER F IH R AH N S
interference(2)	IH N ER F IH R AH N S
interim	IH N T ER AH M
interim(2)	IH N T R AH M
interim(3)	IH N ER AH M
interior	IH N T IH R IY ER
intermediate	IH N T ER M IY D IY IH T
intermediate(2)	IH N ER M IY D IY IH T
internal	IH N T ER N AH L
international	IH N T ER N AE SH AH N AA L
international(2)	IH N ER N AE SH AH N AA L
internationally	IH N T ER N AE SH AH N AA L IY
internationally(2)	IH N T ER N AE SH N AA L IY
internationally(3)	IH N ER N AE SH AH N AA L IY
internationally(4)	IH N ER N AE SH N AA L IY
internet	IH N T ER N EH T
internship	IH N T ER N SH IH P
interpretation	IH N T ER P R IH T EY SH AH N
interpreted	IH N T ER P R AH T AH D
interracial	IH N T ER R EY SH AH L
intersection	IH N T ER S EH K SH AH N
interstate	IH N T ER S T EY T
interval	IH N T ER V AH L
intervention	IH N T ER V EH N SH AH N
interview	IH N T ER V Y UW
intimate	IH N T AH M AH T
intimate(2)	IH N T IH M EY T
intimate(3)	IH N IH M AH T
intranet	IH N T R AH N EH T
intro	IH N T R OW
introduce	IH N T R AH D UW S
introduce(2)	IH N T R OW D UW S
introduced	IH N T R AH D UW S T
introduced(2)	IH N T R OW D UW S T
introducing	IH N T R AH D UW S IH NG
introducing(2)	IH N T R OW D UW S IH NG
introduction	IH N T R AH D AH K SH AH N
introduction(2)	IH N T R OW D AH K SH AH N
introductory	IH N T R AH D AH K T ER IY
introductory(2)	IH N T R OW D AH K T ER IY
invalid	IH N V AH L AH D
invalid(2)	IH N V AH L IH D
invalid(3)	IH N V AE L AH D
invasion	IH N V EY ZH AH N
invention	IH N V EH N SH AH N
inventory	IH N V AH N T AO R IY
invest	IH N V EH S T
investigate	IH N V EH S T AH G EY T
investigated	IH N V EH S T AH G EY T AH D
investigated(2)	IH N V EH S T AH G EY T IH D
investigation	IH N V EH S T AH G EY SH AH N
investigator	IH N V EH S T AH G EY T ER
investing	IH N V EH S T IH NG
investment	IH N V EH S T M AH N T
investment(2)	IH N V EH S M AH N T
investor	IH N V EH S T ER
invisible	IH N V IH Z AH B AH L
invision	IH N V IH ZH AH N
invitation	IH N V IH T EY SH AH N
invite	IH N V AY T
invited	IH N V AY T AH D
invited(2)	IH N V AY T IH D
invoice	IH N V OY S
involve	IH N V AA L V
involved	IH N V AA L V D
involvement	IH N V AA L V M AH N T
involving	IH N V AA L V IH NG
iraqi	IH R AE K IY
iraqi(2)	IY R AE K IY
iraqi(3)	AY R AE K IY
ireland	AY ER L AH N D
ireland(2)	AY R L AH N D
irish	AY R IH SH
irrigation	IH R AH G EY SH AH N
isaac	AY Z AH K
isaac(2)	AY Z IH K
islam	IH S L AA M
islam(2)	IH Z L AH M
islamic	IH Z L AA M IH K
island	AY L AH N D
isolated	AY S AH L EY T AH D
isolated(2)	AY S AH L EY T IH D
isolation	AY S AH L EY SH AH N
israel	IH Z R IY AH L
israel(2)	IH Z R EY L
israeli	IH Z R EY L IY
issue	IH SH UW
issued	IH SH UW D
istanbul	IH S T AA N B UW L
italia	IY T AE L IY AH
italia(2)	IH T AE L Y AH
italiano	IH T AA L IY AA N OW
italic	AY T AE L IH K
italy	IH T AH L IY
items	AY T AH M Z
itself	IH T S EH L F
itunes	AY T UW N Z
ivory	AY V ER IY
ivory(2)	AY V R IY
jacket	JH AE K AH T
jacket(2)	JH AE K IH T
jackie	JH AE K IY
jackson	JH AE K S AH N
jacksonville	JH AE K S AH N V IH L
jaguar	JH AE G W AA R
jamaica	JH AH M EY K AH
january	JH AE N Y UW EH R IY
japanese	JH AE P AH N IY Z
javascript	JH AA V AH S K R IH P T
jeans	JH IY N Z
jefferson	JH EH F ER S AH N
jeffrey	JH EH F R IY
jelsoft	JH EH L S AH F T
jennifer	JH EH N AH F ER
jenny	JH EH N IY
jeremy	JH EH R AH M IY
jerry	JH EH R IY
jersey	JH ER Z IY
jerusalem	JH ER UW S AH L AH M
jesse	JH EH S IY
jessica	JH EH S IH K AH
jesus	JH IY Z AH S
jewel	JH UW AH L
jewel(2)	JH UW L
jewellery	JH UW AH L AH R IY
jewelry	JH UW AH L R IY
jewelry(2)	JH UW L R IY
jewelry(3)	JH UW L ER IY
jewish	JH UW IH SH
jimmy	JH IH M IY
johnny	JH AA N IY
johnson	JH AA N S AH N
johnston	JH AA N S T AH N
joined	JH OY N D
joining	JH OY N IH NG
jonathan	JH AA N AH TH AH N
jordan	JH AO R D AH N
joseph	JH OW S AH F
joseph(2)	JH OW Z AH F
joshua	JH AA SH UW AH
journal	JH ER N AH L
journalism	JH ER N AH L IH Z AH M
journalist	JH ER N AH L AH S T
journalist(2)	JH ER N AH L IH S T
journey	JH ER N IY
judge	JH AH JH
judgment	JH AH JH M AH N T
judicial	JH UW D IH SH AH L
juice	JH UW S
julia	JH UW L Y AH
julie	JH UW L IY
jumping	JH AH M P IH NG
junction	JH AH NG K SH AH N
jungle	JH AH NG G AH L
junior	JH UW N Y ER
jurisdiction	JH UH R AH S D IH K SH AH N
jurisdiction(2)	JH UH R IH S D IH K SH AH N
justice	JH AH S T AH S
justice(2)	JH AH S T IH S
justify	JH AH S T AH F AY
justin	JH AH S T AH N
justin(2)	JH AH S T IH N
juvenile	JH UW V AH N AH L
juvenile(2)	JH UW V AH N AY L
kansas	K AE N Z AH S
karaoke	K EH R IY OW K IY
katrina	K AH T R IY N AH
kazakhstan	K AA Z AA K S T AA N
kazakhstan(2)	K AH Z AE K S T AE N
keeping	K IY P IH NG
kelkoo	K EH L K UW
kentucky	K AH N T AH K IY
kernel	K ER N AH L
keyboard	K IY B AO R D
keyword	K IY W ER D
kidney	K IH D N IY
kijiji	K IH JH AH JH IY
killed	K IH L D
killer	K IH L ER
killing	K IH L IH NG
kills	K IH L Z
kilometers	K AH L AA M AH T ER Z
kilometers(2)	K IH L AH M IY T ER Z
kinase	K AH N EY Z
kinda	K IH N D AH
kinds	K AY N D Z
kinds(2)	K AY N Z
kingdom	K IH NG D AH M
kings	K IH NG Z
kingston	K IH NG S T AH N
kissing	K IH S IH NG
kitchen	K IH CH AH N
kitty	K IH T IY
klein	K L AY N
knife	N AY F
knight	N AY T
knitting	N IH T IH NG
knives	N AY V Z
knock	N AA K
knowing	N OW IH NG
knowledge	N AA L AH JH
knowledge(2)	N AA L IH JH
knowledgestorm	N AA L IH JH S T AO R M
known	N OW N
knows	N OW Z
kodak	K OW D AE K
korea	K AO R IY AH
korean	K AO R IY AH N
kruger	K R UW G ER
kuwait	K UW W EY T
laboratory	L AE B R AH T AO R IY
labour	L EY B ER
lafayette	L AA F IY EH T
lafayette(2)	L AA F EY EH T
lambda	L AE M D AH
lancaster	L AE N K AE S T ER
lancaster(2)	L AE NG K AH S T ER
landing	L AE N D IH NG
landscape	L AE N D S K EY P
landscape(2)	L AE N S K EY P
language	L AE NG G W AH JH
language(2)	L AE NG G W IH JH
laptop	L AE P T AA P
largely	L AA R JH L IY
larger	L AA R JH ER
largest	L AA R JH AH S T
lasting	L AE S T IH NG
lately	L EY T L IY
latest	L EY T AH S T
latina	L AA T IY N AH
latina(2)	L AH T IY N AH
latino	L AA T IY N OW
latino(2)	L AH T IY N OW
latitude	L AE T AH T UW D
latter	L AE T ER
latvia	L AE T V IY AH
lauderdale	L AO D ER D EY L
laughing	L AE F IH NG
launch	L AO N CH
laundry	L AO N D R IY
lauren	L AO R AH N
lawrence	L AO R AH N S
lawsuit	L AO S UW T
lawyer	L AO Y ER
lawyer(2)	L OY ER
layout	L EY AW T
leader	L IY D ER
leadership	L IY D ER SH IH P
leading	L IY D IH NG
leads	L IY D Z
league	L IY G
learn	L ER N
learners	L ER N ER Z
learning	L ER N IH NG
lease	L IY S
leasing	L IY S IH NG
least	L IY S T
leather	L EH DH ER
leave	L IY V
leaving	L IY V IH NG
lebanon	L EH B AH N AH N
lecture	L EH K CH ER
leeds	L IY D Z
legacy	L EH G AH S IY
legal	L IY G AH L
legally	L IY G AH L IY
legend	L EH JH AH N D
legendary	L EH JH AH N D EH R IY
legislation	L EH JH AH S L EY SH AH N
legislative	L EH JH AH S L EY T IH V
legislature	L EH JH AH S L EY CH ER
legitimate	L AH JH IH T AH M AH T
leisure	L EH ZH ER
leisure(2)	L IY ZH ER
lemon	L EH M AH N
lender	L EH N D ER
lending	L EH N D IH NG
length	L EH NG K TH
length(2)	L EH NG TH
lenses	L EH N Z AH Z
lenses(2)	L EH N Z IH Z
leonard	L EH N ER D
leone	L IY OW N
lesbian	L EH Z B IY AH N
leslie	L EH S L IY
lesser	L EH S ER
lesson	L EH S AH N
letter	L EH T ER
letting	L EH T IH NG
level	L EH V AH L
levitra	L AH V IH T R AH
lewis	L UW IH S
lexington	L EH K S IH NG T AH N
lexmark	L EH K S M AA R K
lexus	L EH K S AH S
liability	L AY AH B IH L IH T IY
liable	L AY AH B AH L
liberal	L IH B ER AH L
liberia	L AY B IH R IY AH
liberty	L IH B ER T IY
library	L AY B R EH R IY
licence	L AY S AH N S
license	L AY S AH N S
licensed	L AY S AH N S T
licensing	L AY S AH N S IH NG
licking	L IH K IH NG
liechtenstein	L IH K T AH N S T AY N
lifestyle	L AY F S T AY L
lifetime	L AY F T AY M
light	L AY T
lightbox	L AY T B AA K S
lighter	L AY T ER
lighting	L AY T IH NG
lightning	L AY T N IH NG
lightweight	L AY T W EY T
liked	L AY K T
likelihood	L AY K L IY HH UH D
likely	L AY K L IY
likes	L AY K S
likewise	L AY K W AY Z
limit	L IH M AH T
limitation	L IH M IH T EY SH AH N
limiting	L IH M AH T IH NG
limousines	L IH M AH Z IY N Z
lincoln	L IH NG K AH N
linda	L IH N D AH
lindsay	L IH N D Z IY
linear	L IH N IY ER
lined	L AY N D
lines	L AY N Z
lingerie	L AA N ZH ER EY
linked	L IH NG K T
linking	L IH NG K IH NG
links	L IH NG K S
linux	L IH N AH K S
lions	L AY AH N Z
liquid	L IH K W AH D
liquid(2)	L IH K W IH D
listed	L IH S T AH D
listed(2)	L IH S T IH D
listen	L IH S AH N
listening	L IH S AH N IH NG
listening(2)	L IH S N IH NG
listing	L IH S T IH NG
listprice	L IH S T P R AY S
lists	L IH S T S
literacy	L IH T ER AH S IY
literally	L IH T ER AH L IY
literally(2)	L IH T R AH L IY
literary	L IH T ER EH R IY
literature	L IH T ER AH CH ER
lithuania	L IH TH AH W EY N IY AH
litigation	L IH T AH G EY SH AH N
little	L IH T AH L
livecam	L IH V K AE M
lived	L IH V D
lived(2)	L AY V D
liver	L IH V ER
liverpool	L IH V ER P UW L
lives	L IH V Z
lives(2)	L AY V Z
livesex	L IH V S EH K S
livestock	L AY V S T AA K
living	L IH V IH NG
lloyd	L OY D
loaded	L OW D AH D
loaded(2)	L OW D IH D
loading	L OW D IH NG
loads	L OW D Z
loans	L OW N Z
lobby	L AA B IY
local	L OW K AH L
locale	L OW K AE L
locally	L OW K AH L IY
locate	L OW K EY T
located	L OW K EY T AH D
located(2)	L OW K EY D
location	L OW K EY SH AH N
locator	L OW K EY T ER
locked	L AA K T
locking	L AA K IH NG
locks	L AA K S
lodge	L AA JH
lodging	L AA JH IH NG
logan	L OW G AH N
logged	L AO G D
logging	L AO G IH NG
logic	L AA JH IH K
logical	L AA JH IH K AH L
login	L AA G IH N
logistics	L AH JH IH S T IH K S
logitech	L AA JH AH T AH K
logos	L OW G OW Z
lolita	L OW L IY T AH
london	L AH N D AH N
lonely	L OW N L IY
longer	L AO NG G ER
longest	L AO NG G AH S T
longest(2)	L AO NG G IH S T
longitude	L AA N JH AH T UW D
looked	L UH K T
looking	L UH K IH NG
looks	L UH K S
looksmart	L UH K S M AA R T
lookup	L UH K AH P
loops	L UW P S
loose	L UW S
lopez	L OW P EH Z
losing	L UW Z IH NG
losses	L AO S AH Z
losses(2)	L AO S IH Z
lottery	L AA T ER IY
lotus	L OW T AH S
louis	L UW IH S
louis(2)	L UW IY
louise	L UW IY Z
louisiana	L UW IY Z IY AE N AH
louisville	L UW IY V IH L
lounge	L AW N JH
loved	L AH V D
lovely	L AH V L IY
lover	L AH V ER
loves	L AH V Z
loving	L AH V IH NG
lower	L OW ER
lowest	L OW AH S T
lucas	L UW K AH S
lucia	L UW SH AH
lucky	L AH K IY
luggage	L AH G AH JH
luggage(2)	L AH G IH JH
lunch	L AH N CH
luther	L UW TH ER
luxembourg	L AH K S AH M B AO R G
luxembourg(2)	L AH K S AH M B ER G
luxury	L AH G ZH ER IY
lycos	L AY K OW S
lying	L AY IH NG
lyric	L IH R IH K
macedonia	M AE S AH D OW N IY AH
macedonia(2)	M AE K AH D OW N IY AH
machine	M AH SH IY N
machinery	M AH SH IY N ER IY
machinery(2)	M AH SH IY N R IY
macintosh	M AE K AH N T AO SH
macromedia	M AE K R OW M IY D IY AH
madagascar	M AE D AH G AE S K ER
madison	M AE D AH S AH N
madison(2)	M AE D IH S AH N
madness	M AE D N AH S
madonna	M AH D AA N AH
madrid	M AH D R IH D
magazine	M AE G AH Z IY N
magical	M AE JH IH K AH L
magnet	M AE G N AH T
magnetic	M AE G N EH T IH K
magnificent	M AE G N IH F AH S AH N T
magnificent(2)	M AE G N IH F IH S AH N T
magnitude	M AE G N AH T UW D
maiden	M EY D AH N
mailed	M EY L D
mailing	M EY L IH NG
mailman	M EY L M AE N
mailto	M EY L T OW
mainly	M EY N L IY
mainstream	M EY N S T R IY M
maintain	M EY N T EY N
maintaining	M EY N T EY N IH NG
maintenance	M EY N T AH N AH N S
maintenance(2)	M EY N T N AH N S
majority	M AH JH AO R AH T IY
makeup	M EY K AH P
making	M EY K IH NG
malawi	M AH L AA W IY
malaysia	M AH L EY ZH AH
maldives	M AO L D AY V Z
malpractice	M AE L P R AE K T AH S
malpractice(2)	M AE L P R AE K T IH S
managed	M AE N AH JH D
managed(2)	M AE N IH JH D
management	M AE N AH JH M AH N T
management(2)	M AE N IH JH M AH N T
manager	M AE N AH JH ER
manager(2)	M AE N IH JH ER
managing	M AE N AH JH IH NG
manchester	M AE N CH EH S T ER
mandate	M AE N D EY T
mandatory	M AE N D AH T AO R IY
manhattan	M AE N HH AE T AH N
manitoba	M AE N IH T OW B AH
manually	M AE N Y UW AH L IY
manufacture	M AE N Y AH F AE K CH ER
manufactured	M AE N Y AH F AE K CH ER D
manufacturer	M AE N Y AH F AE K CH ER ER
manufacturing	M AE N Y AH F AE K CH ER IH NG
mapping	M AE P IH NG
marathon	M EH R AH TH AA N
margaret	M AA R G ER IH T
margaret(2)	M AA R G R AH T
margaret(3)	M AA R G R IH T
marijuana	M EH R AH W AA N AH
marilyn	M EH R AH L AH N
marilyn(2)	M EH R AH L IH N
maritime	M AE R AH T AY M
marketing	M AA R K AH T IH NG
marketplace	M AA R K AH T P L EY S
marketplace(2)	M AA R K IH T P L EY S
marking	M AA R K IH NG
marriage	M EH R IH JH
married	M EH R IY D
marriott	M EH R IY AH T
marshall	M AA R SH AH L
martial	M AA R SH AH L
maryland	M EH R AH L AH N D
massachusetts	M AE S AH CH UW S AH T S
massage	M AH S AA ZH
massive	M AE S IH V
master	M AE S T ER
mastercard	M AE S T ER K AA R D
masturbating	M AE S T ER B EY T IH NG
masturbation	M AE S T ER B EY SH AH N
matching	M AE CH IH NG
material	M AH T IH R IY AH L
maternity	M AH T ER N IH T IY
mathematical	M AE TH AH M AE T IH K AH L
mathematics	M AE TH AH M AE T IH K S
mating	M EY T IH NG
matrix	M EY T R IH K S
matter	M AE T ER
matthew	M AE TH Y UW
mattress	M AE T R AH S
mature	M AH CH UH R
mature(2)	M AH T Y UH R
mauritius	M AO R IH T IY AH S
maximize	M AE K S AH M AY Z
maximum	M AE K S AH M AH M
mcdonald	M AH K D AA N AH L D
meals	M IY L Z
meaning	M IY N IH NG
meaningful	M IY N IH NG F AH L
means	M IY N Z
meant	M EH N T
meanwhile	M IY N W AY L
measure	M EH ZH ER
measured	M EH ZH ER D
measurement	M EH ZH ER M AH N T
measuring	M EH ZH ER IH NG
mechanical	M AH K AE N IH K AH L
mechanics	M AH K AE N IH K S
mechanism	M EH K AH N IH Z AH M
medal	M EH D AH L
media	M IY D IY AH
median	M IY D IY AH N
mediawiki	M IY D IY AO AH K IY
medicaid	M EH D AH K EY D
medical	M EH D AH K AH L
medical(2)	M EH D IH K AH L
medicare	M EH D AH K EH R
medication	M EH D AH K EY SH AH N
medicine	M EH D AH S AH N
medieval	M IH D IY V AH L
medieval(2)	M IY D IY V AH L
medieval(3)	M IH D Y IY V AH L
meditation	M EH D AH T EY SH AH N
mediterranean	M EH D AH T ER EY N IY AH N
medium	M IY D IY AH M
medline	M IY D L AY N
meeting	M IY T IH NG
meets	M IY T S
meetup	M IY T AH P
melbourne	M EH L B ER N
melbourne(2)	M EH L B AO N
melissa	M AH L IH S AH
member	M EH M B ER
membership	M EH M B ER SH IH P
membrane	M EH M B R EY N
memorabilia	M EH M ER AH B IY L Y AH
memory	M EH M ER IY
memphis	M EH M F AH S
memphis(2)	M EH M F IH S
memphis(3)	M EH M P F AH S
memphis(4)	M EH M P F IH S
mental	M EH N T AH L
mention	M EH N SH AH N
mentor	M EH N T AO R
mentor(2)	M EH N T ER
menus	M EH N Y UW Z
mercedes	M ER S EY D IY Z
merchandise	M ER CH AH N D AY Z
merchant	M ER CH AH N T
mercy	M ER S IY
merely	M IH R L IY
merge	M ER JH
merger	M ER JH ER
merit	M EH R AH T
merry	M EH R IY
message	M EH S AH JH
message(2)	M EH S IH JH
messaging	M EH S IH JH IH NG
messenger	M EH S AH N JH ER
messenger(2)	M EH S IH N JH ER
metabolism	M AH T AE B AH L IH Z AH M
metadata	M AH T AE D AH T AH
metal	M EH T AH L
metallic	M AH T AE L IH K
metallica	M AH T AE L IH K AH
meter	M IY T ER
method	M EH TH AH D
methodology	M EH TH AH D AA L AH JH IY
metres	M IY T ER Z
metric	M EH T R IH K
metro	M EH T R OW
metropolitan	M EH T R AH P AA L AH T AH N
mexican	M EH K S AH K AH N
mexico	M EH K S AH K OW
meyer	M AY ER
miami	M AY AE M IY
michael	M AY K AH L
michel	M IH SH EH L
michel(2)	M IH CH AH L
michel(3)	M AY K AH L
michelle	M IH SH EH L
michigan	M IH SH IH G AH N
micro	M AY K R OW
microphone	M AY K R AH F OW N
microsoft	M AY K R OW S AO F T
microwave	M AY K R AH W EY V
middle	M IH D AH L
midlands	M IH D L AE N D Z
midnight	M IH D N AY T
midwest	M IH D W EH S T
might	M AY T
mighty	M AY T IY
migration	M AY G R EY SH AH N
milan	M AH L AA N
milan(2)	M IH L AA N
milan(3)	M AY L AE N
mileage	M AY L AH JH
mileage(2)	M AY L IH JH
miles	M AY L Z
miles(2)	M AY AH L Z
milfhunter	M IH L F AH N T AH R
milfs	M IH L F S
military	M IH L AH T EH R IY
military(2)	M IH L IH T EH R IY
millennium	M AH L EH N IY AH M
miller	M IH L ER
million	M IH L Y AH N
mills	M IH L Z
milton	M IH L T AH N
milwaukee	M IH L W AO K IY
minds	M AY N D Z
mineral	M IH N ER AH L
mineral(2)	M IH N R AH L
mines	M AY N Z
miniature	M IH N IY AH CH UH R
miniature(2)	M IH N IH CH UH R
minimal	M IH N AH M AH L
minimize	M IH N AH M AY Z
minimum	M IH N AH M AH M
mining	M AY N IH NG
minister	M IH N AH S T ER
minister(2)	M IH N IH S T ER
ministry	M IH N AH S T R IY
ministry(2)	M IH N IH S T R IY
minneapolis	M IH N IY AE P AH L IH S
minnesota	M IH N IH S OW T AH
minolta	M IH N AA L T AH
minolta(2)	M IH N OW L T AH
minor	M AY N ER
minority	M AY N AO R AH T IY
minority(2)	M AH N AO R AH T IY
minus	M AY N AH S
minute	M IH N AH T
minute(2)	M AY N UW T
minute(3)	M AY N Y UW T
miracle	M IH R AH K AH L
mirror	M IH R ER
miscellaneous	M IH S AH L EY N IY AH S
missed	M IH S T
missile	M IH S AH L
missing	M IH S IH NG
mission	M IH SH AH N
mississippi	M IH S IH S IH P IY
missouri	M AH Z UH R IY
missouri(2)	M AH Z ER AH
mistake	M IH S T EY K
mistress	M IH S T R AH S
mitchell	M IH CH AH L
mitsubishi	M IH T S UW B IY SH IY
mixed	M IH K S T
mixer	M IH K S ER
mixing	M IH K S IH NG
mixture	M IH K S CH ER
mobile	M OW B AH L
mobility	M OW B IH L AH T IY
mobility(2)	M OW B IH L IH T IY
model	M AA D AH L
modeling	M AA D AH L IH NG
modeling(2)	M AA D L IH NG
modelling	M AA D AH L IH NG
modem	M OW D AH M
moderate	M AA D ER AH T
moderate(2)	M AA D ER EY T
moderator	M AA D ER EY T ER
modern	M AA D ER N
modes	M OW D Z
modification	M AA D AH F AH K EY SH AH N
modify	M AA D AH F AY
modular	M AA JH AH L ER
module	M AA JH UW L
moisture	M OY S CH ER
moldova	M OW L D OW V AH
molecular	M AH L EH K Y AH L ER
molecules	M AA L AH K Y UW L Z
moment	M OW M AH N T
momentum	M OW M EH N T AH M
monaco	M AA N AH K OW
monday	M AH N D IY
monday(2)	M AH N D EY
monetary	M AA N AH T EH R IY
money	M AH N IY
mongolia	M AA NG G OW L IY AH
mongolia(2)	M AA NG G OW L Y AH
monica	M AA N IH K AH
monitor	M AA N AH T ER
monitoring	M AA N AH T ER IH NG
monkey	M AH NG K IY
monroe	M AH N R OW
monster	M AA N S T ER
montana	M AA N T AE N AH
monte	M AA N T IY
montgomery	M AA N T G AH M R IY
month	M AH N TH
monthly	M AH N TH L IY
montreal	M AH N T R IY AO L
moore	M UH R
moore(2)	M AO R
moral	M AO R AH L
moreover	M AO R OW V ER
morgan	M AO R G AH N
morning	M AO R N IH NG
morocco	M ER AA K OW
morris	M AO R AH S
morris(2)	M AO R IH S
morrison	M AO R IH S AH N
mortality	M AO R T AE L AH T IY
mortgage	M AO R G AH JH
mortgage(2)	M AO R G IH JH
moscow	M AA S K OW
moscow(2)	M AO S K AW
moses	M OW Z AH S
moses(2)	M OW Z IH S
mostly	M OW S T L IY
mostly(2)	M OW S L IY
motel	M OW T EH L
mother	M AH DH ER
motherboard	M AH DH ER B OW R D
motion	M OW SH AH N
motivated	M OW T AH V EY T AH D
motivation	M OW T AH V EY SH AH N
motor	M OW T ER
motorcycle	M OW T ER S AY K AH L
motorola	M OW T ER OW L AH
mount	M AW N T
mountain	M AW N T AH N
mounting	M AW N T IH NG
mouse	M AW S
mouth	M AW TH
moved	M UW V D
movement	M UW V M AH N T
movers	M UW V ER Z
moves	M UW V Z
movie	M UW V IY
moving	M UW V IH NG
mozambique	M OW Z AE M B IY K
mozambique(2)	M OW Z AH M B IY K
mozilla	M AH Z IH L AH
mpegs	M P EH G Z
msgid	M Z IH D
msgstr	EH M EH S JH IY EH S T IY R
multi	M AH L T IY
multimedia	M AH L T IY M IY D IY AH
multimedia(2)	M AH L T AY M IY D IY AH
multiple	M AH L T AH P AH L
mumbai	M UH M B AY
munich	M Y UW N IH K
municipal	M Y UW N IH S AH P AH L
municipality	M Y UW N IH S AH P AE L AH T IY
murder	M ER D ER
murphy	M ER F IY
murray	M ER IY
murray(2)	M AH R IY
muscle	M AH S AH L
museum	M Y UW Z IY AH M
music	M Y UW Z IH K
musical	M Y UW Z IH K AH L
musician	M Y UW Z IH SH AH N
muslim	M AH Z L AH M
muslim(2)	M AH Z L IH M
mustang	M AH S T AE NG
mutual	M Y UW CH UW AH L
myanmar	M Y AA N M AA R
myers	M AY ER Z
myrtle	M ER T AH L
myself	M AY S EH L F
mysimon	M AY Z IH M AO N
myspace	M AY S P EY S
mysql	M IH S L
mysterious	M IH S T IH R IY AH S
mystery	M IH S T ER IY
nails	N EY L Z
naked	N EY K AH D
named	N EY M D
namely	N EY M L IY
names	N EY M Z
namespace	N EY M S P EY S
namibia	N AH M IH B IY AH
nancy	N AE N S IY
naples	N EY P AH L Z
narrative	N AE R AH T IH V
narrative(2)	N EH R AH T IH V
narrow	N EH R OW
narrow(2)	N AE R OW
nascar	N AE S K AA R
nasdaq	N AE Z D AE K
nashville	N AE SH V IH L
nasty	N AE S T IY
nathan	N EY TH AH N
nation	N EY SH AH N
national	N AE SH AH N AH L
national(2)	N AE SH N AH L
nationally	N AE SH AH N AH L IY
nationally(2)	N AE SH N AH L IY
nationwide	N EY SH AH N W AY D
native	N EY T IH V
natural	N AE CH ER AH L
natural(2)	N AE CH R AH L
naturally	N AE CH ER AH L IY
naturally(2)	N AE CH R AH L IY
nature	N EY CH ER
naughty	N AO T IY
naval	N EY V AH L
navigate	N AE V AH G EY T
navigation	N AE V AH G EY SH AH N
navigator	N AE V AH G EY T ER
nearby	N IH R B AY
nearest	N IH R AH S T
nearly	N IH R L IY
nebraska	N AH B R AE S K AH
necessary	N EH S AH S EH R IY
necessity	N AH S EH S AH T IY
necessity(2)	N AH S EH S IH T IY
necklace	N EH K L AH S
needed	N IY D AH D
needed(2)	N IY D IH D
needle	N IY D AH L
needs	N IY D Z
negative	N EH G AH T IH V
negotiation	N IH G OW SH IY EY SH AH N
neighbor	N EY B ER
neighborhood	N EY B ER HH UH D
neither	N IY DH ER
neither(2)	N AY DH ER
nelson	N EH L S AH N
nepal	N AH P AO L
nerve	N ER V
nervous	N ER V AH S
nested	N EH S T AH D
nested(2)	N EH S T IH D
netherlands	N EH DH ER L AH N D Z
netscape	N EH T S K EY P
network	N EH T W ER K
networking	N EH T W ER K IH NG
neural	N UH R AH L
neural(2)	N Y UH R AH L
neutral	N UW T R AH L
nevada	N AH V AA D AH
nevada(2)	N AH V AE D AH
never	N EH V ER
nevertheless	N EH V ER DH AH L EH S
newark	N UW ER K
newark(2)	N Y UW ER K
newbie	N UW B IY
newcastle	N UW K AE S AH L
newer	N UW ER
newest	N UW AH S T
newfoundland	N UW F AH N D L AH N D
newly	N UW L IY
newman	N UW M AH N
newport	N UW P AO R T
newsletter	N UW Z L EH T ER
newspaper	N UW Z P EY P ER
newton	N UW T AH N
nextel	N EH K S T EH L
niagara	N AY AE G R AH
nicaragua	N IH K ER AA G W AH
nicholas	N IH K AH L AH S
nicholas(2)	N IH K L AH S
nickel	N IH K AH L
nickname	N IH K N EY M
nicole	N IH K OW L
niger	N AY JH ER
nigeria	N AY JH IH R IY AH
night	N AY T
nightlife	N AY T L AY F
nightmare	N AY T M EH R
nikon	N AY K AA N
nintendo	N IH N T EH N D OW
nipple	N IH P AH L
nirvana	N IH R V AA N AH
nirvana(2)	N ER V AA N AH
nissan	N IY S AA N
nitrogen	N AY T R AH JH AH N
noble	N OW B AH L
nobody	N OW B AA D IY
nobody(2)	N OW B AH D IY
nodes	N OW D Z
noise	N OY Z
nokia	N OW K IY AH
nominated	N AA M AH N EY T AH D
nomination	N AA M AH N EY SH AH N
nonprofit	N AA N P R AA F AH T
norfolk	N AO R F AH K
normal	N AO R M AH L
normally	N AO R M AH L IY
normally(2)	N AO R M L IY
norman	N AO R M AH N
north	N AO R TH
northeast	N AO R TH IY S T
northern	N AO R DH ER N
northwest	N AO R TH W EH S T
norton	N AO R T AH N
norway	N AO R W EY
norwegian	N AO R W IY JH AH N
notebook	N OW T B UH K
noted	N OW T AH D
noted(2)	N OW T IH D
notes	N OW T S
nothing	N AH TH IH NG
notice	N OW T AH S
notice(2)	N OW T IH S
noticed	N OW T IH S T
notification	N OW T AH F AH K EY SH AH N
notify	N OW T AH F AY
notion	N OW SH AH N
notre	N OW T R AH
notre(2)	N OW T ER
nottingham	N AA T IH NG HH AE M
novel	N AA V AH L
novelty	N AA V AH L T IY
november	N OW V EH M B ER
nowhere	N OW W EH R
nowhere(2)	N OW HH W EH R
nuclear	N UW K L IY ER
nudist	N UW D IH S T
nudity	N UW D IH T IY
number	N AH M B ER
numeric	N UW M EH R IH K
numerical	N UW M EH R AH K AH L
numerical(2)	N UW M EH R IH K AH L
numerous	N UW M ER AH S
nurse	N ER S
nursery	N ER S ER IY
nursing	N ER S IH NG
nutrition	N UW T R IH SH AH N
nutritional	N UW T R IH SH AH N AH L
nutten	N AH T AH N
nvidia	N V IH D IY AH
nylon	N AY L AA N
oakland	OW K L AH N D
oasis	OW EY S IH S
obesity	OW B IY S AH T IY
obesity(2)	AH B IY S AH T IY
obituaries	OW B IH CH UW EH R IY Z
object	AA B JH EH K T
object(2)	AH B JH EH K T
objective	AH B JH EH K T IH V
obligation	AA B L AH G EY SH AH N
observation	AA B Z ER V EY SH AH N
observe	AH B Z ER V
observed	AH B Z ER V D
observer	AH B Z ER V ER
obtain	AH B T EY N
obtaining	AH B T EY N IH NG
obvious	AA B V IY AH S
obviously	AA B V IY AH S L IY
occasion	AH K EY ZH AH N
occasional	AO K EY ZH AH N AH L
occasionally	AO K EY ZH AH N AH L IY
occupation	AA K Y AH P EY SH AH N
occupational	AA K Y AH P EY SH AH N AH L
occupied	AA K Y AH P AY D
occur	AH K ER
occurred	AH K ER D
occurrence	AH K ER AH N S
occurring	AH K ER IH NG
ocean	OW SH AH N
october	AA K T OW B ER
offense	AH F EH N S
offensive	AH F EH N S IH V
offer	AO F ER
offering	AO F ER IH NG
offering(2)	AO F R IH NG
office	AO F AH S
officer	AO F AH S ER
officer(2)	AO F IH S ER
official	AH F IH SH AH L
officially	AH F IH SH AH L IY
offline	AO F L AY N
offset	AO F S EH T
offshore	AO F SH AO R
often	AO F T AH N
often(2)	AO F AH N
oklahoma	OW K L AH HH OW M AH
older	OW L D ER
oldest	OW L D AH S T
olive	AA L AH V
olive(2)	AA L IH V
oliver	AA L AH V ER
oliver(2)	AA L IH V ER
olympic	OW L IH M P IH K
olympus	OW L IH M P AH S
omaha	OW M AH HH AA
omega	OW M EH G AH
omega(2)	OW M EY G AH
omissions	OW M IH SH AH N Z
ongoing	AA N G OW IH NG
ongoing(2)	AO N G OW IH NG
onion	AH N Y AH N
ontario	AA N T EH R IY OW
opened	OW P AH N D
opening	OW P AH N IH NG
opens	OW P AH N Z
opera	AA P R AH
operate	AA P ER EY T
operate(2)	AO P ER EY T
operated	AA P ER EY T AH D
operating	AA P ER EY T IH NG
operating(2)	AO P ER EY T IH NG
operation	AA P ER EY SH AH N
operational	AA P ER EY SH AH N AH L
operator	AA P ER EY T ER
opinion	AH P IH N Y AH N
opponent	AH P OW N AH N T
opportunity	AA P ER T UW N AH T IY
opposed	AH P OW Z D
opposite	AA P AH Z IH T
opposition	AA P AH Z IH SH AH N
optical	AA P T IH K AH L
optics	AA P T IH K S
optimal	AA P T AH M AH L
optimization	AA P T AH M AH Z EY SH AH N
optimize	AA P T AH M AY Z
optimum	AA P T AH M AH M
option	AA P SH AH N
option(2)	AO P SH AH N
optional	AA P SH AH N AH L
optional(2)	AO P SH AH N AH L
oracle	AO R AH K AH L
orange	AO R AH N JH
orange(2)	AO R IH N JH
orbit	AO R B AH T
orchestra	AO R K AH S T R AH
order	AO R D ER
ordering	AO R D ER IH NG
ordinance	AO R D AH N AH N S
ordinary	AO R D AH N EH R IY
oregon	AO R AH G AH N
oregon(2)	AO R AH G AA N
organ	AO R G AH N
organic	AO R G AE N IH K
organisation	AO R G AH N IH Z EY SH AH N
organised	AO R G AH N IY Z D
organisms	AO R G AH N IH Z AH M Z
organization	AO R G AH N AH Z EY SH AH N
organizational	AO R G AH N AH Z EY SH AH N AH L
organize	AO R G AH N AY Z
organized	AO R G AH N AY Z D
organizer	AO R G AH N AY Z ER
organizing	AO R G AH N AY Z IH NG
oriental	AO R IY EH N T AH L
oriental(2)	AO R IY EH N AH L
orientation	AO R IY EH N T EY SH AH N
oriented	AO R IY EH N T AH D
oriented(2)	AO R IY EH N T IH D
origin	AO R AH JH AH N
original	ER IH JH AH N AH L
originally	ER IH JH AH N AH L IY
originally(2)	ER IH JH N AH L IY
orlando	AO R L AE N D OW
orleans	AO R L IY N Z
oscar	AO S K ER
other	AH DH ER
otherwise	AH DH ER W AY Z
ottawa	AA T AH W AA
ought	AO T
ourselves	AW ER S EH L V Z
ourselves(2)	AA R S EH L V Z
outcome	AW T K AH M
outdoor	AW T D AO R
outer	AW T ER
outlet	AW T L EH T
outline	AW T L AY N
outlined	AW T L AY N D
outlook	AW T L UH K
output	AW T P UH T
outreach	AW T R IY CH
outside	AW T S AY D
outsourcing	AW T S AO R S IH NG
outstanding	AW T S T AE N D IH NG
overall	OW V ER AO L
overcome	OW V ER K AH M
overhead	OW V ER HH EH D
overnight	OW V ER N AY T
overseas	OW V ER S IY Z
overview	OW V ER V Y UW
owned	OW N D
owner	OW N ER
ownership	OW N ER SH IH P
oxford	AA K S F ER D
oxide	AA K S AY D
oxygen	AA K S AH JH AH N
oxygen(2)	AA K S IH JH AH N
ozone	OW Z OW N
pacific	P AH S IH F IH K
package	P AE K AH JH
package(2)	P AE K IH JH
packaging	P AE K IH JH IH NG
packard	P AE K ER D
packed	P AE K T
packet	P AE K AH T
packet(2)	P AE K IH T
packing	P AE K IH NG
painful	P EY N F AH L
paintball	P EY N T B AA L
painting	P EY N T IH NG
painting(2)	P EY N IH NG
pakistan	P AE K IH S T AE N
palace	P AE L AH S
palestine	P AE L AH S T AY N
palestinian	P AE L IH S T IH N IY AH N
palmer	P AA M ER
palmer(2)	P AA L M ER
pamela	P AE M AH L AH
panama	P AE N AH M AA
panasonic	P AE N AH S AA N IH K
panties	P AE N T IY Z
pantyhose	P AE N T IY HH OW Z
paperback	P EY P ER B AE K
parade	P ER EY D
paradise	P EH R AH D AY S
paragraph	P AE R AH G R AE F
paragraph(2)	P EH R AH G R AE F
paraguay	P EH R AH G W EY
parallel	P EH R AH L EH L
parameter	P ER AE M AH T ER
parcel	P AA R S AH L
parent	P EH R AH N T
parental	P ER EH N T AH L
parenting	P EH R AH N T IH NG
parish	P AE R IH SH
parish(2)	P EH R IH SH
parker	P AA R K ER
parking	P AA R K IH NG
parliament	P AA R L AH M EH N T
parliamentary	P AA R L AH M EH N T ER IY
partially	P AA R SH AH L IY
partially(2)	P AA R SH L IY
participant	P AA R T IH S AH P AH N T
participate	P AA R T IH S AH P EY T
participated	P AA R T IH S AH P EY T AH D
participated(2)	P AA R T IH S AH P EY T IH D
participating	P AA R T IH S AH P EY T IH NG
participation	P AA R T IH S AH P EY SH AH N
particle	P AA R T AH K AH L
particle(2)	P AA R T IH K AH L
particular	P ER T IH K Y AH L ER
particular(2)	P AA T IH K Y AH L ER
particularly	P AA R T IH K Y AH L ER L IY
particularly(2)	P ER T IH K Y AH L ER L IY
partition	P AA R T IH SH AH N
partly	P AA R T L IY
partnership	P AA R T N ER SH IH P
passage	P AE S AH JH
passage(2)	P AE S IH JH
passed	P AE S T
passenger	P AE S AH N JH ER
passes	P AE S AH Z
passes(2)	P AE S IH Z
passing	P AE S IH NG
passion	P AE SH AH N
passive	P AE S IH V
passport	P AE S P AO R T
password	P AE S W ER D
pastor	P AE S T ER
patent	P AE T AH N T
pathology	P AH TH AA L AH JH IY
patient	P EY SH AH N T
patricia	P AH T R IH SH AH
patrick	P AE T R IH K
patrol	P AH T R OW L
pattern	P AE T ER N
pavilion	P AH V IH L Y AH N
payable	P EY AH B AH L
payday	P EY D EY
paying	P EY IH NG
payment	P EY M AH N T
paypal	P EY P AE L
payroll	P EY R OW L
peace	P IY S
peaceful	P IY S F AH L
pearl	P ER L
pediatric	P IY D IY AE T R IH K
peeing	P IY IH NG
peers	P IH R Z
penalty	P EH N AH L T IY
pencil	P EH N S AH L
pendant	P EH N D AH N T
pending	P EH N D IH NG
penetration	P EH N AH T R EY SH AH N
penguin	P EH NG G W AH N
peninsula	P AH N IH N S AH L AH
penis	P IY N IH S
pennsylvania	P EH N S AH L V EY N Y AH
penny	P EH N IY
pension	P EH N SH AH N
pentium	P EH N T IY AH M
people	P IY P AH L
pepper	P EH P ER
perceived	P ER S IY V D
percent	P ER S EH N T
percentage	P ER S EH N T AH JH
percentage(2)	P ER S EH N AH JH
percentage(3)	P ER S EH N T IH JH
percentage(4)	P ER S EH N IH JH
perception	P ER S EH P SH AH N
perfect	P ER F EH K T
perfect(2)	P ER F IH K T
perfectly	P ER F AH K T L IY
perfectly(2)	P ER F AH K L IY
perform	P ER F AO R M
performance	P ER F AO R M AH N S
performer	P ER F AO R M ER
performing	P ER F AO R M IH NG
perfume	P ER F Y UW M
perhaps	P ER HH AE P S
period	P IH R IY AH D
periodic	P IH R IY AA D IH K
periodically	P IY R IY AA D IH K AH L IY
periodically(2)	P IY R IY AA D IH K L IY
peripheral	P ER IH F ER AH L
peripheral(2)	P ER IH F R AH L
permalink	P ER M AE L IH NG K
permanent	P ER M AA N EH N T
permission	P ER M IH SH AH N
permit	P ER M IH T
permitted	P ER M IH T AH D
permitted(2)	P ER M IH T IH D
perry	P EH R IY
persian	P ER ZH AH N
persistent	P ER S IH S T AH N T
person	P ER S AH N
personal	P ER S IH N AH L
personality	P ER S AH N AE L IH T IY
personalized	P ER S AH N AH L AY Z D
personally	P ER S AH N AH L IY
personnel	P ER S AH N EH L
perspective	P ER S P EH K T IH V
perth	P ER TH
peter	P IY T ER
petersburg	P IY T ER Z B ER G
peterson	P IY T ER S AH N
petite	P AH T IY T
petition	P AH T IH SH AH N
petroleum	P AH T R OW L IY AH M
phantom	F AE N T AH M
phantom(2)	F AE N AH M
pharmaceutical	F AA R M AH S UW T IH K AH L
pharmacology	F AA R M AH K AA L AH JH IY
pharmacy	F AA R M AH S IY
phase	F EY Z
phenomenon	F AH N AA M AH N AA N
phentermine	F EH N T AH R M AY N
philadelphia	F IH L AH D EH L F IY AH
philip	F IH L AH P
philip(2)	F IH L IH P
philippines	F IH L AH P IY N Z
phillips	F IH L IH P S
philosophy	F AH L AA S AH F IY
phoenix	F IY N IH K S
phone	F OW N
photo	F OW T OW
photograph	F OW T AH G R AE F
photographer	F AH T AA G R AH F ER
photographic	F OW T AH G R AE F IH K
photography	F AH T AA G R AH F IY
photoshop	F OW T OW SH AA P
phpbb	P IY EY CH P IY B IY B
phrase	F R EY Z
physical	F IH Z IH K AH L
physically	F IH Z IH K AH L IY
physically(2)	F IH Z IH K L IY
physician	F AH Z IH SH AH N
physics	F IH Z IH K S
physiology	F IH Z IY AA L AH JH IY
piano	P IY AE N OW
piano(2)	P IY AE N AH
pichunter	P AH CH AH N T AH R
picked	P IH K T
picking	P IH K IH NG
picks	P IH K S
pickup	P IH K AH P
picnic	P IH K N IH K
picture	P IH K CH ER
piece	P IY S
pierce	P IH R S
pierre	P IY EH R
pillow	P IH L OW
pills	P IH L Z
pilot	P AY L AH T
pioneer	P AY AH N IH R
pipeline	P AY P L AY N
pipes	P AY P S
pirates	P AY R AH T S
pissing	P IH S IH NG
pitch	P IH CH
pittsburgh	P IH T S B ER G
pixel	P IH K S AH L
pizza	P IY T S AH
place	P L EY S
placement	P L EY S M AH N T
placing	P L EY S IH NG
plain	P L EY N
plaintiff	P L EY N T AH F
plaintiff(2)	P L EY N AH F
plane	P L EY N
planned	P L AE N D
planner	P L AE N ER
planning	P L AE N IH NG
plans	P L AE N Z
plant	P L AE N T
plastic	P L AE S T IH K
plate	P L EY T
platform	P L AE T F AO R M
platinum	P L AE T N AH M
platinum(2)	P L AE T AH N AH M
playback	P L EY B AE K
playboy	P L EY B OY
playing	P L EY IH NG
playlist	P L EY L IH S T
plays	P L EY Z
playstation	P L EY S T EY SH AH N
plaza	P L AA Z AH
plaza(2)	P L AE Z AH
pleasant	P L EH Z AH N T
please	P L IY Z
pleased	P L IY Z D
pleasure	P L EH ZH ER
pledge	P L EH JH
plenty	P L EH N T IY
plenty(2)	P L EH N IY
plots	P L AA T S
plugin	P L AH G IH N
plumbing	P L AH M IH NG
plymouth	P L IH M AH TH
pocket	P AA K AH T
podcast	P AO D K AE S T
poems	P OW AH M Z
poetry	P OW AH T R IY
point	P OY N T
pointer	P OY N T ER
pointing	P OY N T IH NG
poison	P OY Z AH N
pokemon	P AA K AH M AH N
poker	P OW K ER
polar	P OW L ER
political	P AH L IH T AH K AH L
political(2)	P AH L IH T IH K AH L
politicians	P AA L AH T IH SH AH N Z
politics	P AA L AH T IH K S
polls	P OW L Z
pollution	P AH L UW SH AH N
polyester	P AA L IY EH S T ER
polymer	P AA L AH M ER
polyphonic	P AA L IH F AA N IH K
pontiac	P AA N T IY AE K
pontiac(2)	P AA N IY AE K
pools	P UW L Z
popular	P AA P Y AH L ER
popularity	P AA P Y AH L EH R AH T IY
population	P AA P Y AH L EY SH AH N
porcelain	P AO R S AH L AH N
porno	P AO R N OW
porsche	P AO R SH AH
porsche(2)	P AO R SH
portable	P AO R T AH B AH L
portal	P AO R T AH L
porter	P AO R T ER
portfolio	P AO R T F OW L IY OW
portion	P AO R SH AH N
portland	P AO R T L AH N D
portrait	P AO R T R AH T
ports	P AO R T S
portsmouth	P AO R T S M AH TH
portugal	P AO R CH AH G AH L
portuguese	P AO R CH AH G IY Z
posing	P OW Z IH NG
position	P AH Z IH SH AH N
positioning	P AH Z IH SH AH N IH NG
positive	P AA Z AH T IH V
possess	P AH Z EH S
possession	P AH Z EH SH AH N
possibility	P AA S AH B IH L AH T IY
possible	P AA S AH B AH L
possibly	P AA S AH B L IY
postage	P OW S T AH JH
postage(2)	P OW S T IH JH
postal	P OW S T AH L
postcard	P OW S T K AA R D
postcard(2)	P OW S K AA R D
posted	P OW S T IH D
poster	P OW S T ER
posting	P OW S T IH NG
postposted	P OW S T P OW S T IH D
posts	P OW S T S
potato	P AH T EY T OW
potential	P AH T EH N SH AH L
potentially	P AH T EH N SH AH L IY
potter	P AA T ER
pottery	P AA T ER IY
poultry	P OW L T R IY
pound	P AW N D
poverty	P AA V ER T IY
powder	P AW D ER
powell	P AA W EH L
power	P AW ER
powerful	P AW ER F AH L
powerpoint	P AW ER P OY N T
powerseller	P AW ER S EH L ER
practical	P R AE K T IH K AH L
practice	P R AE K T IH S
practitioner	P R AE K T IH SH AH N ER
prairie	P R EH R IY
preceding	P R IY S IY D IH NG
precious	P R EH SH AH S
precipitation	P R IH S IH P IH T EY SH AH N
precise	P R IH S AY S
precise(2)	P R IY S AY S
precisely	P R IH S AY S L IY
precisely(2)	P R IY S AY S L IY
precision	P R IY S IH ZH AH N
predict	P R IH D IH K T
predict(2)	P R IY D IH K T
prediction	P R IY D IH K SH AH N
prefer	P R AH F ER
prefer(2)	P R IH F ER
prefer(3)	P R IY F ER
preference	P R EH F ER AH N S
preference(2)	P R EH F R AH N S
preferred	P R AH F ER D
preferred(2)	P R IH F ER D
preferred(3)	P R IY F ER D
prefix	P R IY F IH K S
pregnancy	P R EH G N AH N S IY
pregnant	P R EH G N AH N T
preliminary	P R IH L IH M AH N EH R IY
preliminary(2)	P R IY L IH M AH N EH R IY
premier	P R EH M IH R
premier(2)	P R IY M IH R
premiere	P R EH M IH R
premises	P R EH M AH S AH Z
premium	P R IY M IY AH M
prepaid	P R IY P EY D
preparation	P R EH P ER EY SH AH N
prepare	P R IY P EH R
prepared	P R IY P EH R D
preparing	P R IY P EH R IH NG
preparing(2)	P ER P EH R IH NG
prerequisite	P R IY R EH K W AH Z AH T
prescribed	P R IY S K R AY B D
prescription	P R AH S K R IH P SH AH N
presence	P R EH Z AH N S
present	P R EH Z AH N T
present(2)	P R IY Z EH N T
present(3)	P ER Z EH N T
presentation	P R EH Z AH N T EY SH AH N
presenting	P R IH Z EH N T IH NG
presenting(2)	P R IY Z EH N T IH NG
presently	P R EH Z AH N T L IY
preservation	P R EH Z ER V EY SH AH N
preserve	P R AH Z ER V
preserve(2)	P R IH Z ER V
preserve(3)	P R IY Z ER V
president	P R EH Z IH D AH N T
presidential	P R EH Z IH D EH N SH AH L
press	P R EH S
pressing	P R EH S IH NG
pressure	P R EH SH ER
preston	P R EH S T AH N
pretty	P R IH T IY
prevent	P R IH V EH N T
prevent(2)	P R IY V EH N T
preventing	P R IH V EH N T IH NG
preventing(2)	P R IY V EH N T IH NG
preventing(3)	P R IH V EH N IH NG
preventing(4)	P R IY V EH N IH NG
prevention	P R IY V EH N SH AH N
preview	P R IY V Y UW
previous	P R IY V IY AH S
previously	P R IY V IY AH S L IY
price	P R AY S
priced	P R AY S T
pricing	P R AY S IH NG
pride	P R AY D
priest	P R IY S T
primary	P R AY M EH R IY
prime	P R AY M
prince	P R IH N S
princess	P R IH N S EH S
princeton	P R IH N S T AH N
principal	P R IH N S AH P AH L
principle	P R IH N S AH P AH L
print	P R IH N T
printable	P R IH N T AH B AH L
printer	P R IH N T ER
printer(2)	P R IH N ER
printing	P R IH N T IH NG
printing(2)	P R IH N IH NG
prior	P R AY ER
priority	P R AY AO R AH T IY
prison	P R IH Z AH N
prisoner	P R IH Z AH N ER
prisoner(2)	P R IH Z N ER
privacy	P R AY V AH S IY
private	P R AY V AH T
privilege	P R IH V IH L IH JH
prize	P R AY Z
probability	P R AA B AH B IH L AH T IY
probably	P R AA B AH B L IY
probe	P R OW B
problem	P R AA B L AH M
procedure	P R AH S IY JH ER
procedure(2)	P R OW S IY JH ER
proceed	P R AH S IY D
proceed(2)	P R OW S IY D
proceed(3)	P ER S IY D
proceeding	P R AH S IY D IH NG
proceeding(2)	P R OW S IY D IH NG
process	P R AA S EH S
process(2)	P R AO S EH S
processing	P R AA S EH S IH NG
processor	P R AA S EH S ER
procurement	P R OW K Y UH R M AH N T
produce	P R AH D UW S
produce(2)	P R OW D UW S
produced	P R AH D UW S T
producer	P R AH D UW S ER
producing	P R AH D UW S IH NG
product	P R AA D AH K T
production	P R AH D AH K SH AH N
production(2)	P R OW D AH K SH AH N
production(3)	P ER D AH K SH AH N
productive	P R AH D AH K T IH V
productive(2)	P R OW D AH K T IH V
productive(3)	P ER D AH K T IH V
productivity	P R OW D AH K T IH V AH T IY
productivity(2)	P R OW D AH K T IH V IH T IY
profession	P R AH F EH SH AH N
professional	P R AH F EH SH AH N AH L
professor	P R AH F EH S ER
profile	P R OW F AY L
profit	P R AA F AH T
profit(2)	P R AA F IH T
program	P R OW G R AE M
programme	P R OW G R AE M
programmer	P R OW G R AE M ER
programming	P R OW G R AE M IH NG
progress	P R AA G R EH S
progress(2)	P R AH G R EH S
progress(3)	P R OW G R EH S
progressive	P R AH G R EH S IH V
prohibited	P R OW HH IH B AH T AH D
project	P R AA JH EH K T
projection	P R AA JH EH K SH AH N
projector	P R AA JH EH K T ER
prominent	P R AA M AH N AH N T
promise	P R AA M AH S
promised	P R AA M AH S T
promising	P R AA M AH S IH NG
promo	P R OW M OW
promote	P R AH M OW T
promoted	P R AH M OW T AH D
promoting	P R AH M OW T IH NG
promotion	P R AH M OW SH AH N
promotion(2)	P ER M OW SH AH N
promotional	P R AH M OW SH AH N AH L
promotional(2)	P ER M OW SH AH N AH L
prompt	P R AA M P T
promptly	P R AA M P T L IY
promptly(2)	P R AA M P L IY
proof	P R UW F
propecia	P R OW P IY SH IY AH
proper	P R AA P ER
properly	P R AA P ER L IY
property	P R AA P ER T IY
prophet	P R AA F AH T
proportion	P R AH P AO R SH AH N
proposal	P R AH P OW Z AH L
propose	P R AH P OW Z
proposed	P R AH P OW Z D
proposition	P R AA P AH Z IH SH AH N
proprietary	P R AH P R AY AH T EH R IY
prospect	P R AA S P EH K T
prospective	P R AH S P EH K T IH V
prostate	P R AA S T EY T
prostores	P R OW S T OW R Z
protect	P R AH T EH K T
protecting	P R AH T EH K T IH NG
protection	P R AH T EH K SH AH N
protective	P R AH T EH K T IH V
protein	P R OW T IY N
protest	P R OW T EH S T
protest(2)	P R AH T EH S T
protocol	P R OW T AH K AA L
protocol(2)	P R OW T AH K AO L
prototype	P R OW T OW T AY P
proud	P R AW D
proudly	P R AW D L IY
prove	P R UW V
proved	P R UW V D
proven	P R UW V AH N
provide	P R AH V AY D
provided	P R AH V AY D AH D
provided(2)	P R AH V AY D IH D
providence	P R AA V AH D AH N S
provider	P R AH V AY D ER
providing	P R AH V AY D IH NG
province	P R AA V AH N S
province(2)	P R AA V IH N S
provincial	P R AH V IH N SH AH L
provision	P R AH V IH ZH AH N
proxy	P R AA K S IY
prozac	P R OW Z AE K
psychiatry	S AY K AY AH T R IY
psychiatry(2)	S IH K AY AH T R IY
psychological	S AY K AH L AA JH IH K AH L
psychology	S AY K AA L AH JH IY
public	P AH B L IH K
publication	P AH B L IH K EY SH AH N
publicity	P AH B L IH S AH T IY
publicity(2)	P AH B L IH S IH T IY
publicly	P AH B L IH K L IY
publish	P AH B L IH SH
publisher	P AH B L IH SH ER
publishing	P AH B L IH SH IH NG
pubmed	P AH B M D
puerto	P W EH R T OW
puerto(2)	P AO R T AH
puerto(3)	P AO R T ER
pulled	P UH L D
pulling	P UH L IH NG
pulse	P AH L S
pumps	P AH M P S
punch	P AH N CH
punishment	P AH N IH SH M AH N T
pupils	P Y UW P AH L Z
puppy	P AH P IY
purchase	P ER CH AH S
purchased	P ER CH AH S T
purchasing	P ER CH AH S IH NG
purple	P ER P AH L
purpose	P ER P AH S
purse	P ER S
pursuant	P ER S UW AH N T
pursue	P ER S UW
pursuit	P ER S UW T
pushed	P UH SH T
pushing	P UH SH IH NG
pussy	P UH S IY
putting	P AH T IH NG
putting(2)	P UH T IH NG
puzzle	P AH Z AH L
python	P AY TH AA N
qatar	K AH T AA R
qualification	K W AA L AH F AH K EY SH AH N
qualify	K W AA L AH F AY
qualifying	K W AA L AH F AY IH NG
quality	K W AA L AH T IY
quantitative	K W AA N T IH T EY T IH V
quantity	K W AA N T AH T IY
quantum	K W AA N T AH M
quarter	K W AO R T ER
quarterly	K W AO R T ER L IY
quebec	K W AH B EH K
queen	K W IY N
queensland	K W IY N Z L AE N D
query	K W IY R IY
quest	K W EH S T
question	K W EH S CH AH N
question(2)	K W EH SH AH N
questionnaire	K W EH S CH AH N EH R
queue	K Y UW
quick	K W IH K
quickly	K W IH K L IY
quiet	K W AY AH T
quilt	K W IH L T
quite	K W AY T
quizzes	K W IH Z IH Z
quotations	K W OW T EY SH AH N Z
quote	K W OW T
quoted	K W OW T IH D
rabbit	R AE B AH T
rabbit(2)	R AE B IH T
rachel	R EY CH AH L
racial	R EY SH AH L
racing	R EY S IH NG
radiation	R EY D IY EY SH AH N
radical	R AE D IH K AH L
radius	R EY D IY AH S
railroad	R EY L R OW D
railway	R EY L W EY
rainbow	R EY N B OW
raised	R EY Z D
raising	R EY Z IH NG
raleigh	R AO L IY
random	R AE N D AH M
ranger	R EY N JH ER
ranging	R EY N JH IH NG
ranked	R AE NG K T
ranking	R AE NG K IH NG
rapidly	R AE P AH D L IY
rarely	R EH R L IY
rather	R AE DH ER
rather(2)	R AH DH ER
rating	R EY T IH NG
rational	R AE SH AH N AH L
rational(2)	R AE SH N AH L
raymond	R EY M AH N D
reach	R IY CH
reaching	R IY CH IH NG
reaction	R IY AE K SH AH N
reader	R IY D ER
reads	R IY D Z
ready	R EH D IY
realistic	R IY AH L IH S T IH K
reality	R IY AE L AH T IY
realize	R IY AH L AY Z
realized	R IY AH L AY Z D
really	R IH L IY
really(2)	R IY L IY
realm	R EH L M
realtor	R IY AH L T ER
realtor(2)	R IY L T ER
realty	R IY AH L T IY
reason	R IY Z AH N
reasonable	R IY Z AH N AH B AH L
reasonable(2)	R IY Z N AH B AH L
reasonably	R IY Z AH N AH B L IY
reasoning	R IY Z AH N IH NG
rebate	R IY B EY T
rebecca	R AH B EH K AH
rebel	R EH B AH L
rebel(2)	R IH B EH L
rebound	R IY B AW N D
recall	R IY K AO L
recall(2)	R IH K AO L
receipt	R IH S IY T
receipt(2)	R IY S IY T
receive	R AH S IY V
receive(2)	R IH S IY V
receive(3)	R IY S IY V
received	R AH S IY V D
received(2)	R IH S IY V D
received(3)	R IY S IY V D
receiver	R AH S IY V ER
receiver(2)	R IH S IY V ER
receiver(3)	R IY S IY V ER
receiving	R AH S IY V IH NG
receiving(2)	R IH S IY V IH NG
receiving(3)	R IY S IY V IH NG
recent	R IY S AH N T
recently	R IY S AH N T L IY
recently(2)	R IY S AH N L IY
reception	R IH S EH P SH AH N
reception(2)	R IY S EH P SH AH N
receptor	R IY S EH P T ER
recipe	R EH S AH P IY
recipient	R AH S IH P IY AH N T
recipient(2)	R IH S IH P IY AH N T
recognised	R EH K AH G N AY Z D
recognition	R EH K AH G N IH SH AH N
recognition(2)	R EH K IH G N IH SH AH N
recognize	R EH K AH G N AY Z
recognized	R EH K AH G N AY Z D
recommend	R EH K AH M EH N D
recommendation	R EH K AH M AH N D EY SH AH N
reconstruction	R IY K AH N S T R AH K SH AH N
record	R AH K AO R D
record(2)	R EH K ER D
record(3)	R IH K AO R D
recorder	R IH K AO R D ER
recorder(2)	R IY K AO R D ER
recording	R AH K AO R D IH NG
recording(2)	R IH K AO R D IH NG
recover	R IH K AH V ER
recovery	R IH K AH V R IY
recovery(2)	R IH K AH V ER IY
recreation	R EH K R IY EY SH AH N
recreational	R EH K R IY EY SH AH N AH L
recruiting	R AH K R UW T IH NG
recruiting(2)	R IH K R UW T IH NG
recruiting(3)	R IY K R UW T IH NG
recruitment	R AH K R UW T M AH N T
recruitment(2)	R IH K R UW T M AH N T
recruitment(3)	R IY K R UW T M AH N T
recycling	R IY S AY K AH L IH NG
recycling(2)	R IY S AY K L IH NG
redeem	R IH D IY M
redhead	R EH D HH EH D
reduce	R IH D UW S
reduced	R IH D UW S T
reducing	R IH D UW S IH NG
reduction	R IH D AH K SH AH N
refer	R AH F ER
refer(2)	R IH F ER
reference	R EH F ER AH N S
reference(2)	R EH F R AH N S
referenced	R EH F ER AH N S T
referenced(2)	R EH F R AH N S T
referral	R IH F ER AH L
referred	R AH F ER D
referred(2)	R IH F ER D
referring	R IH F ER IH NG
refinance	R IY F AH N AE N S
refinance(2)	R IY F AY N AE N S
refine	R AH F AY N
refine(2)	R IH F AY N
refined	R AH F AY N D
refined(2)	R IH F AY N D
reflect	R AH F L EH K T
reflect(2)	R IH F L EH K T
reflection	R AH F L EH K SH AH N
reflection(2)	R IH F L EH K SH AH N
reform	R AH F AO R M
reform(2)	R IH F AO R M
refresh	R IH F R EH SH
refrigerator	R AH F R IH JH ER EY T ER
refrigerator(2)	R IH F R IH JH ER EY T ER
refugees	R EH F Y UW JH IY Z
refund	R IH F AH N D
refund(2)	R IY F AH N D
refurbished	R IY F ER B IH SH T
refuse	R AH F Y UW Z
refuse(2)	R EH F Y UW Z
refuse(3)	R IH F Y UW Z
refused	R AH F Y UW Z D
refused(2)	R IH F Y UW Z D
regard	R AH G AA R D
regard(2)	R IH G AA R D
regarding	R AH G AA R D IH NG
regarding(2)	R IH G AA R D IH NG
regardless	R AH G AA R D L AH S
reggae	R EH G EY
regime	R AH ZH IY M
regime(2)	R EY ZH IY M
region	R IY JH AH N
regional	R IY JH AH N AH L
register	R EH JH IH S T ER
registrar	R EH JH IH S T R AA R
registration	R EH JH IH S T R EY SH AH N
registry	R EH JH IH S T R IY
regression	R AH G R EH SH AH N
regular	R EH G Y AH L ER
regular(2)	R EY G Y AH L ER
regularly	R EH G Y AH L ER L IY
regulated	R EH G Y AH L EY T AH D
regulated(2)	R EH G Y AH L EY T IH D
regulation	R EH G Y AH L EY SH AH N
regulatory	R EH G Y AH L AH T AO R IY
rehab	R IY HH AE B
rehabilitation	R IY HH AH B IH L AH T EY SH AH N
rehabilitation(2)	R IY AH B IH L AH T EY SH AH N
reject	R IH JH EH K T
reject(2)	R IY JH EH K T
relating	R IH L EY T IH NG
relating(2)	R IY L EY T IH NG
relation	R IY L EY SH AH N
relationship	R IY L EY SH AH N SH IH P
relative	R EH L AH T IH V
relatively	R EH L AH T IH V L IY
relax	R IH L AE K S
relax(2)	R IY L AE K S
relaxation	R IY L AE K S EY SH AH N
relay	R IY L EY
release	R IY L IY S
released	R IY L IY S T
relevance	R EH L AH V AH N S
relevant	R EH L AH V AH N T
reliability	R IY L AY AH B IH L AH T IY
reliable	R IH L AY AH B AH L
reliable(2)	R IY L AY AH B AH L
reliance	R IH L AY AH N S
reliance(2)	R IY L AY AH N S
religion	R IH L IH JH AH N
religion(2)	R IY L IH JH AH N
religious	R IH L IH JH AH S
religious(2)	R IY L IH JH AH S
relocation	R IY L OW K EY SH AH N
relying	R IY L AY IH NG
remain	R IH M EY N
remain(2)	R IY M EY N
remainder	R IH M EY N D ER
remainder(2)	R IY M EY N D ER
remaining	R IH M EY N IH NG
remaining(2)	R IY M EY N IH NG
remark	R IH M AA R K
remark(2)	R IY M AA R K
remarkable	R IH M AA R K AH B AH L
remarkable(2)	R IY M AA R K AH B AH L
remedy	R EH M AH D IY
remember	R IH M EH M B ER
remember(2)	R IY M EH M B ER
remind	R IY M AY N D
reminder	R IY M AY N D ER
remix	R IY M IH K S
remote	R IH M OW T
remote(2)	R IY M OW T
removable	R IH M UW V AH B AH L
removal	R IH M UW V AH L
remove	R IY M UW V
removed	R IY M UW V D
removing	R IY M UW V IH NG
renaissance	R EH N AH S AA N S
render	R EH N D ER
rendering	R EH N D ER IH NG
renew	R IH N UW
renewable	R IY N UW AH B AH L
renewal	R IH N UW AH L
rental	R EH N T AH L
repair	R IH P EH R
repeat	R IH P IY T
repeat(2)	R IY P IY T
replaced	R IY P L EY S T
replacement	R IH P L EY S M AH N T
replacing	R IH P L EY S IH NG
replication	R EH P L IH K EY SH AH N
reply	R IH P L AY
reply(2)	R IY P L AY
report	R IY P AO R T
report(2)	R IH P AO R T
reporter	R IH P AO R T ER
reporting	R IY P AO R T IH NG
reporting(2)	R IH P AO R T IH NG
repository	R IY P AA Z AH T AO R IY
represent	R EH P R AH Z EH N T
represent(2)	R EH P R IH Z EH N T
representation	R EH P R AH Z EH N T EY SH AH N
representative	R EH P R AH Z EH N T AH T IH V
representative(2)	R EH P R IH Z EH N T AH T IH V
representative(3)	R EH P R AH Z EH N AH T IH V
representative(4)	R EH P R IH Z EH N AH T IH V
representing	R EH P R IH Z EH N T IH NG
representing(2)	R EH P R IH Z EH N IH NG
reprint	R IY P R IH N T
reproduce	R IY P R AH D UW S
reproduced	R IY P R AH D UW S T
reproduction	R IY P R AH D AH K SH AH N
reproductive	R IY P R AH D AH K T IH V
republic	R IY P AH B L AH K
republic(2)	R IY P AH B L IH K
republican	R IH P AH B L IH K AH N
republican(2)	R IY P AH B L AH K AH N
republican(3)	R IY P AH B L IH K AH N
reputation	R EH P Y AH T EY SH AH N
request	R IH K W EH S T
request(2)	R IY K W EH S T
requesting	R IH K W EH S T IH NG
requesting(2)	R IY K W EH S T IH NG
require	R IY K W AY ER
require(2)	R IY K W AY R
require(3)	R IH K W AY ER
required	R IY K W AY ER D
required(2)	R IY K W AY R D
requirement	R IH K W AY R M AH N T
requiring	R IY K W AY ER IH NG
requiring(2)	R IY K W AY R IH NG
rescue	R EH S K Y UW
research	R IY S ER CH
researcher	R IY S ER CH ER
reseller	R IY S EH L ER
reservation	R EH Z ER V EY SH AH N
reserve	R IH Z ER V
reserve(2)	R IY Z ER V
reserved	R IH Z ER V D
reserved(2)	R IY Z ER V D
reservoir	R EH Z AH V W AA R
reservoir(2)	R EH Z ER V W AA R
reset	R IY S EH T
residence	R EH Z IH D AH N S
resident	R EH Z IH D AH N T
residential	R EH Z IH D EH N SH AH L
resist	R IH Z IH S T
resist(2)	R IY Z IH S T
resistance	R IH Z IH S T AH N S
resistance(2)	R IY Z IH S T AH N S
resistant	R IH Z IH S T AH N T
resistant(2)	R IY Z IH S T AH N T
resolution	R EH Z AH L UW SH AH N
resolve	R IY Z AA L V
resolved	R IY Z AA L V D
resort	R IH Z AO R T
resort(2)	R IY Z AO R T
resort(3)	R IY S AO R T
resource	R IY S AO R S
respect	R IH S P EH K T
respect(2)	R IY S P EH K T
respective	R IH S P EH K T IH V
respective(2)	R IY S P EH K T IH V
respectively	R IH S P EH K T IH V L IY
respiratory	R EH S P ER AH T AO R IY
respond	R IH S P AA N D
respond(2)	R IY S P AA N D
respondent	R IH S P AA N D AH N T
responding	R IH S P AA N D IH NG
responding(2)	R IY S P AA N D IH NG
response	R IH S P AA N S
response(2)	R IY S P AA N S
responsibility	R IY S P AA N S AH B IH L AH T IY
responsible	R IY S P AA N S AH B AH L
restaurant	R EH S T ER AA N T
restaurant(2)	R EH S T R AA N T
restoration	R EH S T ER EY SH AH N
restore	R IH S T AO R
restored	R IH S T AO R D
restrict	R IY S T R IH K T
restriction	R IY S T R IH K SH AH N
restructuring	R IY S T R AH K CH ER IH NG
result	R IH Z AH L T
result(2)	R IY Z AH L T
resulting	R IH Z AH L T IH NG
resulting(2)	R IY Z AH L T IH NG
resume	R IH Z UW M
resume(2)	R IY Z UW M
resume(3)	R EH Z AH M EY
retail	R IY T EY L
retailer	R IY T EY L ER
retain	R IH T EY N
retain(2)	R IY T EY N
retention	R IY T EH N SH AH N
retired	R IH T AY R D
retired(2)	R IY T AY ER D
retired(3)	R IY T AY R D
retirement	R IY T AY ER M AH N T
retirement(2)	R IH T AY ER M AH N T
retreat	R IY T R IY T
retrieval	R IH T R IY V AH L
retrieval(2)	R IY T R IY V AH L
retrieve	R IH T R IY V
retrieve(2)	R IY T R IY V
retrieved	R IY T R IY V D
retro	R EH T R OW
return	R IH T ER N
return(2)	R IY T ER N
returning	R IH T ER N IH NG
returning(2)	R IY T ER N IH NG
reunion	R IY UW N Y AH N
reuters	R OY T ER Z
reveal	R IH V IY L
reveal(2)	R IY V IY L
revelation	R EH V AH L EY SH AH N
revenge	R IY V EH N JH
revenue	R EH V AH N UW
revenue(2)	R EH V AH N Y UW
reverse	R IH V ER S
reverse(2)	R IY V ER S
review	R IY V Y UW
reviewer	R IY V Y UW ER
reviewing	R IY V Y UW IH NG
revised	R IH V AY Z D
revised(2)	R IY V AY Z D
revision	R IY V IH ZH AH N
revolution	R EH V AH L UW SH AH N
revolutionary	R EH V AH L UW SH AH N EH R IY
reward	R IH W AO R D
reward(2)	R IY W AO R D
reynolds	R EH N AH L D Z
rhode	R OW D
rhythm	R IH DH AH M
ribbon	R IH B AH N
richard	R IH CH ER D
richardson	R IH CH ER D S AH N
richmond	R IH CH M AH N D
ricky	R IH K IY
rider	R AY D ER
rides	R AY D Z
ridge	R IH JH
riding	R AY D IH NG
right	R AY T
rings	R IH NG Z
ringtone	R IH NG T OW N
rising	R AY Z IH NG
risks	R IH S K S
river	R IH V ER
riverside	R IH V ER S AY D
robbie	R AA B IY
robert	R AA B ER T
robertson	R AA B ER T S AH N
robinson	R AA B AH N S AH N
robust	R OW B AH S T
rochester	R AA CH EH S T ER
rocket	R AA K AH T
roland	R OW L AH N D
rolled	R OW L D
roller	R OW L ER
rolling	R OW L IH NG
romance	R OW M AE N S
romania	R OW M EY N IY AH
romantic	R OW M AE N T IH K
ronald	R AA N AH L D
roommate	R UW M EY T
roster	R AA S T ER
rotary	R OW T ER IY
rotation	R OW T EY SH AH N
roughly	R AH F L IY
roulette	R UW L EH T
router	R UW T ER
router(2)	R AW T ER
routine	R UW T IY N
routing	R AW T IH NG
routing(2)	R UW T IH NG
royalty	R OY AH L T IY
rugby	R AH G B IY
ruled	R UW L D
rules	R UW L Z
ruling	R UW L IH NG
runner	R AH N ER
running	R AH N IH NG
runtime	R AH N T AY M
rural	R UH R AH L
russell	R AH S AH L
russia	R AH SH AH
russian	R AH SH AH N
rwanda	R AH W AA N D AH
rwanda(2)	R UW AA N D AH
sacramento	S AE K R AH M EH N T OW
sacred	S EY K R AH D
sacred(2)	S EY K R IH D
sacrifice	S AE K R AH F AY S
saddam	S AA D AH M
saddam(2)	S AH D AA M
safari	S AH F AA R IY
safely	S EY F L IY
safety	S EY F T IY
sailing	S EY L IH NG
salary	S AE L ER IY
salmon	S AE M AH N
salvador	S AE L V AH D AO R
salvation	S AE L V EY SH AH N
sample	S AE M P AH L
sampling	S AE M P L IH NG
samsung	S AE M S AH NG
samuel	S AE M Y UW L
sandra	S AE N D R AH
sandwich	S AE N D W IH CH
sandwich(2)	S AE N W IH CH
sandwich(3)	S AE M W IH CH
sapphire	S AE F AY ER
saskatchewan	S AE S K AE CH AH W AO N
satellite	S AE T AH L AY T
satisfaction	S AE T AH S F AE K SH AH N
satisfaction(2)	S AE T IH S F AE K SH AH N
satisfactory	S AE T AH S F AE K T R IY
satisfactory(2)	S AE T IH S F AE K T ER IY
satisfy	S AE T AH S F AY
satisfy(2)	S AE T IH S F AY
saturday	S AE T ER D IY
saturday(2)	S AE T IH D EY
saturn	S AE T ER N
savage	S AE V AH JH
savage(2)	S AE V IH JH
savannah	S AH V AE N AH
saving	S EY V IH NG
saying	S EY IH NG
sbjct	EH S B IY JH EY S IY T
scale	S K EY L
scanned	S K AE N D
scanner	S K AE N ER
scanning	S K AE N IH NG
scared	S K EH R D
scary	S K EH R IY
scenario	S IH N EH R IY OW
scene	S IY N
scenic	S IY N IH K
schedule	S K EH JH UH L
schedule(2)	S K EH JH UW L
scheduled	S K EH JH UH L D
scheduled(2)	S K EH JH UW L D
scheduling	S K EH JH UH L IH NG
scheduling(2)	S K EH JH UW L IH NG
schema	S K IY M AH
scheme	S K IY M
scholar	S K AA L ER
scholarship	S K AA L ER SH IH P
school	S K UW L
science	S AY AH N S
scientific	S AY AH N T IH F IH K
scientist	S AY AH N T IH S T
scoop	S K UW P
scope	S K OW P
score	S K AO R
scored	S K AO R D
scoring	S K AO R IH NG
scotia	S K OW SH AH
scotland	S K AA T L AH N D
scott	S K AA T
scottish	S K AA T IH SH
scout	S K AW T
scratch	S K R AE CH
screen	S K R IY N
screening	S K R IY N IH NG
screensaver	S K R IY N S EY V ER
screenshot	S K R IY N SH AA T
screw	S K R UW
script	S K R IH P T
scripting	S K R IH P T IH NG
scroll	S K R OW L
scuba	S K UW B AH
sculpture	S K AH L P CH ER
seafood	S IY F UW D
sealed	S IY L D
search	S ER CH
searching	S ER CH IH NG
season	S IY Z AH N
seasonal	S IY Z AH N AH L
seating	S IY T IH NG
seats	S IY T S
seattle	S IY AE T AH L
second	S EH K AH N D
secondary	S EH K AH N D EH R IY
secret	S IY K R AH T
secret(2)	S IY K R IH T
secretary	S EH K R AH T EH R IY
section	S EH K SH AH N
sector	S EH K T ER
secure	S IH K Y UH R
secured	S IH K Y UH R D
securely	S IH K Y UH R L IY
security	S IH K Y UH R AH T IY
seeds	S IY D Z
seeing	S IY IH NG
seeker	S IY K ER
seeking	S IY K IH NG
seeks	S IY K S
seemed	S IY M D
seems	S IY M Z
segment	S EH G M AH N T
segment(2)	S EH G M EH N T
select	S AH L EH K T
selecting	S AH L EH K T IH NG
selection	S AH L EH K SH AH N
selective	S AH L EH K T IH V
seller	S EH L ER
selling	S EH L IH NG
sells	S EH L Z
semester	S AH M EH S T ER
semiconductor	S EH M IY K AH N D AH K T ER
semiconductor(2)	S EH M IH K AH N D AH K T ER
semiconductor(3)	S EH M AY K AH N D AH K T ER
seminar	S EH M AH N AA R
senate	S EH N AH T
senate(2)	S EH N IH T
senator	S EH N AH T ER
sender	S EH N D ER
sending	S EH N D IH NG
sends	S EH N D Z
senegal	S EH N AH G AO L
senior	S IY N Y ER
sense	S EH N S
sensitive	S EH N S AH T IH V
sensitive(2)	S EH N S IH T IH V
sensitivity	S EH N S IH T IH V IH T IY
sensor	S EH N S ER
sentence	S EH N T AH N S
separate	S EH P ER EY T
separate(2)	S EH P ER IH T
separate(3)	S EH P R AH T
separated	S EH P ER EY T AH D
separated(2)	S EH P ER EY T IH D
separately	S EH P ER AH T L IY
separately(2)	S EH P R AH T L IY
separation	S EH P ER EY SH AH N
september	S EH P T EH M B ER
sequence	S IY K W AH N S
serbia	S ER B IY AH
serial	S IH R IY AH L
series	S IH R IY Z
serious	S IH R IY AH S
seriously	S IH R IY AH S L IY
serum	S IH R AH M
serve	S ER V
served	S ER V D
server	S ER V ER
service	S ER V AH S
service(2)	S ER V IH S
serving	S ER V IH NG
session	S EH SH AH N
setting	S EH T IH NG
settle	S EH T AH L
settled	S EH T AH L D
settlement	S EH T AH L M AH N T
setup	S EH T AH P
seven	S EH V AH N
seventh	S EH V AH N TH
several	S EH V ER AH L
severe	S AH V IH R
sewing	S OW IH NG
sexuality	S EH K SH UW AE L AH T IY
sexually	S EH K SH UW AH L IY
shade	SH EY D
shadow	SH AE D OW
shaft	SH AE F T
shake	SH EY K
shakespeare	SH EY K S P IY R
shakira	SH AE K IY R AH
shall	SH AE L
shame	SH EY M
shanghai	SH AE NG HH AY
shannon	SH AE N AH N
shape	SH EY P
shaped	SH EY P T
share	SH EH R
shared	SH EH R D
shareholders	SH EH R HH OW L D ER Z
shareware	SH EH R W EH R
sharing	SH EH R IH NG
shark	SH AA R K
sharon	SH AE R AH N
sharon(2)	SH EH R AH N
sharon(3)	SH AH R OW N
sharp	SH AA R P
shaved	SH EY V D
sheep	SH IY P
sheer	SH IH R
sheet	SH IY T
sheffield	SH EH F IY L D
shelf	SH EH L F
shell	SH EH L
shelter	SH EH L T ER
shemale	SH AH M EY L
shepherd	SH EH P ER D
sheriff	SH EH R AH F
sheriff(2)	SH EH R IH F
sherman	SH ER M AH N
shield	SH IY L D
shift	SH IH F T
shine	SH AY N
shipment	SH IH P M AH N T
shipped	SH IH P T
shipping	SH IH P IH NG
ships	SH IH P S
shirt	SH ER T
shock	SH AA K
shoes	SH UW Z
shoot	SH UW T
shooting	SH UW T IH NG
shopper	SH AA P ER
shopping	SH AA P IH NG
shops	SH AA P S
shopzilla	SH AA P Z IH L AH
shore	SH AO R
short	SH AO R T
shortcuts	SH AO R T K AH T S
shorter	SH AO R T ER
shortly	SH AO R T L IY
shots	SH AA T S
should	SH UH D
shoulder	SH OW L D ER
showcase	SH OW K EY S
showed	SH OW D
shower	SH AW ER
showing	SH OW IH NG
shown	SH OW N
shows	SH OW Z
showtimes	SH OW T AY M Z
shuttle	SH AH T AH L
sides	S AY D Z
siemens	S IY M AH N Z
sierra	S IY EH R AH
sight	S AY T
sigma	S IH G M AH
signal	S IH G N AH L
signature	S IH G N AH CH ER
signed	S AY N D
significance	S AH G N IH F IH K AH N S
significance(2)	S IH G N IH F IH K AH N S
significant	S AH G N IH F IH K AH N T
significant(2)	S IH G N IH F IH K AH N T
significantly	S IH G N IH F IH K AH N T L IY
signing	S AY N IH NG
signs	S AY N Z
signup	S AY N AH P
silence	S AY L AH N S
silent	S AY L AH N T
silicon	S IH L AH K AH N
silly	S IH L IY
silver	S IH L V ER
similar	S IH M AH L ER
similarly	S IH M AH L ER L IY
simon	S AY M AH N
simple	S IH M P AH L
simplified	S IH M P L AH F AY D
simply	S IH M P L IY
simpson	S IH M P S AH N
simulation	S IH M Y AH L EY SH AH N
simultaneously	S AY M AH L T EY N IY AH S L IY
since	S IH N S
singapore	S IH NG AH P AO R
singer	S IH NG ER
singh	S IH NG
singing	S IH NG IH NG
single	S IH NG G AH L
sister	S IH S T ER
sitemap	S AY T M AE P
sites	S AY T S
sitting	S IH T IH NG
situated	S IH CH UW EY T IH D
situation	S IH CH UW EY SH AH N
sixth	S IH K S TH
sized	S AY Z D
sizes	S AY Z AH Z
sizes(2)	S AY Z IH Z
skating	S K EY T IH NG
skiing	S K IY IH NG
slave	S L EY V
sleep	S L IY P
sleeping	S L IY P IH NG
sleeve	S L IY V
slide	S L AY D
slideshow	S L AY D SH OW
slight	S L AY T
slightly	S L AY T L IY
slope	S L OW P
slots	S L AA T S
slovak	S L OW V AA K
slovakia	S L OW V AA K IY AH
slovenia	S L OW V IY N IY AH
slowly	S L OW L IY
sluts	S L AH T S
small	S M AO L
smaller	S M AO L ER
smallest	S M AO L AH S T
smart	S M AA R T
smell	S M EH L
smile	S M AY L
smilies	S M AY L IY Z
smith	S M IH TH
smithsonian	S M IH TH S OW N IY AH N
smithsonian(2)	S M IH S OW N IY AH N
smoke	S M OW K
smoking	S M OW K IH NG
smooth	S M UW DH
snake	S N EY K
snapshot	S N AE P SH AA T
snowboard	S N OW B AO R D
soccer	S AA K ER
social	S OW SH AH L
society	S OW S AY IH T IY
sociology	S OW S IY AA L AH JH IY
socket	S AA K AH T
socks	S AA K S
sodium	S OW D IY AH M
softball	S AO F T B AO L
softball(2)	S AO F B AO L
software	S AO F T W EH R
software(2)	S AO F W EH R
solar	S OW L ER
solaris	S OW L EH R IH S
soldier	S OW L JH ER
solely	S OW AH L IY
solid	S AA L AH D
solomon	S AA L AH M AH N
solution	S AH L UW SH AH N
solve	S AA L V
solved	S AA L V D
solving	S AA L V IH NG
somalia	S AH M AA L IY AH
somalia(2)	S AH M AA L Y AH
somebody	S AH M B AA D IY
somebody(2)	S AH M B AH D IY
somehow	S AH M HH AW
someone	S AH M W AH N
somerset	S AH M ER S EH T
something	S AH M TH IH NG
sometimes	S AH M T AY M Z
somewhat	S AH M W AH T
somewhat(2)	S AH M HH W AH T
somewhere	S AH M W EH R
songs	S AO NG Z
sonic	S AA N IH K
soonest	S UW N AH S T
sophisticated	S AH F IH S T AH K EY T IH D
sophisticated(2)	S AH F IH S T IH K EY T AH D
sorry	S AA R IY
sorted	S AO R T IH D
sorts	S AO R T S
sought	S AO T
souls	S OW L Z
sound	S AW N D
soundtrack	S AW N D T R AE K
soundtrack(2)	S AW N T R AE K
source	S AO R S
south	S AW TH
southampton	S AW TH HH AE M P T AH N
southeast	S AW TH IY S T
southern	S AH DH ER N
southwest	S AW TH W EH S T
soviet	S OW V IY AH T
soviet(2)	S OW V IY EH T
spanish	S P AE N IH SH
spanking	S P AE NG K IH NG
spatial	S P EY SH AH L
speaker	S P IY K ER
speaking	S P IY K IH NG
spears	S P IH R Z
special	S P EH SH AH L
specialist	S P EH SH AH L IH S T
specialized	S P EH SH AH L AY Z D
specializing	S P EH SH AH L AY Z IH NG
specially	S P EH SH AH L IY
specially(2)	S P EH SH L IY
specialty	S P EH SH AH L T IY
specialty(2)	S P EY SH AH L T IY
species	S P IY SH IY Z
specific	S P AH S IH F IH K
specific(2)	S P IH S IH F IH K
specifically	S P AH S IH F IH K L IY
specification	S P EH S IH F IH K EY SH AH N
specify	S P EH S AH F AY
spectacular	S P EH K T AE K Y AH L ER
spectrum	S P EH K T R AH M
speech	S P IY CH
spelling	S P EH L IH NG
spencer	S P EH N S ER
spending	S P EH N D IH NG
sphere	S F IH R
spider	S P AY D ER
spirit	S P IH R AH T
spirit(2)	S P IH R IH T
spiritual	S P IH R IH CH UW AH L
spirituality	S P IH R IH CH UW AE L AH T IY
spoken	S P OW K AH N
spokesman	S P OW K S M AH N
sponsor	S P AA N S ER
sponsorship	S P AA N S ER SH IH P
sporting	S P AO R T IH NG
spotlight	S P AA T L AY T
spouse	S P AW S
spread	S P R EH D
spreading	S P R EH D IH NG
spring	S P R IH NG
spring(2)	S P ER IH NG
springer	S P R IH NG ER
springfield	S P R IH NG F IY L D
sprint	S P R IH N T
spyware	S P AY W EH R
squad	S K W AA D
square	S K W EH R
squirt	S K W ER T
squirting	S K W ER T IH NG
stability	S T AH B IH L IH T IY
stack	S T AE K
stadium	S T EY D IY AH M
staff	S T AE F
staffing	S T AE F IH NG
stage	S T EY JH
stainless	S T EY N L AH S
stake	S T EY K
stakeholders	S T EY K HH OW L D ER Z
stamp	S T AE M P
stand	S T AE N D
standard	S T AE N D ER D
standing	S T AE N D IH NG
stanford	S T AE N F ER D
stanley	S T AE N L IY
starring	S T AA R IH NG
stars	S T AA R Z
starsmerchant	S T AA R Z M ER CH AH N T
start	S T AA R T
starter	S T AA R T ER
starting	S T AA R T IH NG
startup	S T AA R T AH P
state	S T EY T
statement	S T EY T M AH N T
statewide	S T EY T W AY D
stating	S T EY T IH NG
station	S T EY SH AH N
stationery	S T EY SH AH N EH R IY
statistical	S T AH T IH S T IH K AH L
statistics	S T AH T IH S T IH K S
stats	S T AE T S
statute	S T AE CH UW T
statutory	S T AE CH AH T AO R IY
staying	S T EY IH NG
stays	S T EY Z
steady	S T EH D IY
steal	S T IY L
steam	S T IY M
steel	S T IY L
steering	S T IH R IH NG
stephanie	S T EH F AH N IY
stephen	S T IY V AH N
steps	S T EH P S
stereo	S T EH R IY OW
sterling	S T ER L IH NG
steve	S T IY V
steven	S T IY V AH N
stewart	S T UW ER T
stick	S T IH K
sticker	S T IH K ER
sticky	S T IH K IY
still	S T IH L
stock	S T AA K
stockholm	S T AA K HH OW L M
stockings	S T AA K IH NG Z
stolen	S T OW L AH N
stomach	S T AH M AH K
stone	S T OW N
stood	S T UH D
stopped	S T AA P T
stopping	S T AA P IH NG
stops	S T AA P S
store	S T AO R
stored	S T AO R D
storm	S T AO R M
story	S T AO R IY
straight	S T R EY T
strain	S T R EY N
strand	S T R AE N D
strange	S T R EY N JH
stranger	S T R EY N JH ER
strap	S T R AE P
strategic	S T R AH T IY JH IH K
strategy	S T R AE T AH JH IY
stream	S T R IY M
streaming	S T R IY M IH NG
street	S T R IY T
strength	S T R EH NG K TH
strength(2)	S T R EH NG TH
strengthen	S T R EH NG TH AH N
strengthening	S T R EH NG TH AH N IH NG
stress	S T R EH S
stretch	S T R EH CH
strict	S T R IH K T
strictly	S T R IH K T L IY
strike	S T R AY K
striking	S T R AY K IH NG
string	S T R IH NG
strip	S T R IH P
stripes	S T R AY P S
stroke	S T R OW K
strong	S T R AO NG
stronger	S T R AO NG G ER
strongly	S T R AO NG L IY
struck	S T R AH K
struct	S T R AH K T
structural	S T R AH K CH ER AH L
structure	S T R AH K CH ER
structured	S T R AH K CH ER D
struggle	S T R AH G AH L
stuart	S T UW ER T
stuart(2)	S T Y UW ER T
stuart(3)	S T AO R T
stuck	S T AH K
studio	S T UW D IY OW
study	S T AH D IY
studying	S T AH D IY IH NG
stuff	S T AH F
stunning	S T AH N IH NG
stupid	S T UW P AH D
stupid(2)	S T UW P IH D
style	S T AY L
stylish	S T AY L IH SH
stylus	S T AY L AH S
subaru	S UW B ER UW
subcommittee	S AH B K AH M IH T IY
subdivision	S AH B D IH V IH ZH AH N
subject	S AH B JH EH K T
subject(2)	S AH B JH IH K T
subjective	S AH B JH EH K T IH V
sublime	S AH B L AY M
sublimedirectory	S AH B L AY M D AH R EH K T ER IY
submission	S AH B M IH SH AH N
submit	S AH B M IH T
submitted	S AH B M IH T AH D
submitting	S AH B M IH T IH NG
subscribe	S AH B S K R AY B
subscriber	S AH B S K R AY B ER
subscription	S AH B S K R IH P SH AH N
subsection	S AH B S EH K SH AH N
subsequent	S AH B S AH K W AH N T
subsequently	S AH B S AH K W AH N T L IY
subsidiary	S AH B S IH D IY EH R IY
substance	S AH B S T AH N S
substantial	S AH B S T AE N SH AH L
substantially	S AH B S T AE N SH AH L IY
substitute	S AH B S T AH T UW T
subtle	S AH T AH L
suburban	S AH B ER B AH N
succeed	S AH K S IY D
success	S AH K S EH S
successful	S AH K S EH S F AH L
successfully	S AH K S EH S F AH L IY
sucking	S AH K IH NG
sucks	S AH K S
sudan	S UW D AE N
sudden	S AH D AH N
suddenly	S AH D AH N L IY
suffer	S AH F ER
suffering	S AH F ER IH NG
suffering(2)	S AH F R IH NG
sufficient	S AH F IH SH AH N T
sufficiently	S AH F IH SH AH N T L IY
sugar	SH UH G ER
suggest	S AH JH EH S T
suggesting	S AH JH EH S T IH NG
suggestion	S AH JH EH S CH AH N
suicide	S UW AH S AY D
suicide(2)	S UW IH S AY D
suitable	S UW T AH B AH L
suite	S W IY T
suited	S UW T AH D
suited(2)	S UW T IH D
suits	S UW T S
sullivan	S AH L AH V AH N
sullivan(2)	S AH L IH V AH N
summary	S AH M ER IY
summer	S AH M ER
summit	S AH M AH T
summit(2)	S AH M IH T
sunday	S AH N D EY
sunday(2)	S AH N D IY
sunglasses	S AH N G L AE S IH Z
sunny	S AH N IY
sunrise	S AH N R AY Z
sunset	S AH N S EH T
sunshine	S AH N SH AY N
super	S UW P ER
superb	S UH P ER B
superintendent	S UW P ER AH N T EH N D AH N T
superintendent(2)	S UW P ER IH N T EH N D AH N T
superior	S UW P IH R IY ER
supervision	S UW P ER V IH ZH AH N
supervisor	S UW P ER V AY Z ER
supplement	S AH P L AH M AH N T
supplement(2)	S AH P L AH M EH N T
supplemental	S AH P L AH M EH N T AH L
supply	S AH P L AY
support	S AH P AO R T
supporters	S AH P AO R T ER Z
supporting	S AH P AO R T IH NG
suppose	S AH P OW Z
supposed	S AH P OW Z D
supreme	S AH P R IY M
supreme(2)	S ER P R IY M
surely	SH UH R L IY
surface	S ER F AH S
surfing	S ER F IH NG
surge	S ER JH
surgeon	S ER JH AH N
surgeon(2)	S ER JH IH N
surgery	S ER JH ER IY
surgical	S ER JH IH K AH L
surname	S ER N EY M
surplus	S ER P L AH S
surprise	S ER P R AY Z
surprise(2)	S AH P R AY Z
surprised	S ER P R AY Z D
surprised(2)	S AH P R AY Z D
surprising	S ER P R AY Z IH NG
surprising(2)	S AH P R AY Z IH NG
surrey	S ER IY
surround	S ER AW N D
surrounding	S ER AW N D IH NG
surveillance	S ER V EY L AH N S
survey	S ER V EY
survival	S ER V AY V AH L
survive	S ER V AY V
survivor	S ER V AY V ER
susan	S UW Z AH N
suspect	S AH S P EH K T
suspended	S AH S P EH N D AH D
suspended(2)	S AH S P EH N D IH D
suspension	S AH S P EH N SH AH N
sussex	S AH S IH K S
sustainability	S AH S T EY N AH B IH L IH T IY
sustainable	S AH S T EY N AH B AH L
sustained	S AH S T EY N D
suzuki	S AH Z UW K IY
swaziland	S W AA Z IH L AH N D
sweden	S W IY D AH N
swedish	S W IY D IH SH
sweet	S W IY T
swift	S W IH F T
swimming	S W IH M IH NG
swing	S W IH NG
swingers	S W IH NG ER Z
swiss	S W IH S
switch	S W IH CH
switching	S W IH CH IH NG
switzerland	S W IH T S ER L AH N D
sword	S AO R D
sydney	S IH D N IY
symantec	S IH M AE N T EH K
symbol	S IH M B AH L
sympathy	S IH M P AH TH IY
symphony	S IH M F AH N IY
symposium	S IH M P OW Z IY AH M
symptoms	S IH M P T AH M Z
syndicate	S IH N D IH K AH T
syndicate(2)	S IH N D AH K EY T
syndication	S IH N D IH K EY SH AH N
syndrome	S IH N D R OW M
synopsis	S IH N AA P S IH S
syntax	S IH N T AE K S
synthesis	S IH N TH AH S AH S
synthetic	S IH N TH EH T IH K
syracuse	S IH R AH K Y UW Z
syria	S IH R IY AH
system	S IH S T AH M
systematic	S IH S T AH M AE T IH K
table	T EY B AH L
tablet	T AE B L AH T
tackle	T AE K AH L
tactics	T AE K T IH K S
tagged	T AE G D
tahoe	T AE HH OW
taiwan	T AY W AA N
taken	T EY K AH N
takes	T EY K S
taking	T EY K IH NG
talent	T AE L AH N T
tales	T EY L Z
talked	T AO K T
talking	T AO K IH NG
talks	T AO K S
tamil	T AH M IH L
tamil(2)	T AE M IH L
tampa	T AE M P AH
tanks	T AE NG K S
tanzania	T AE N Z EY N IY AH
tanzania(2)	T AE N Z AH N IY AH
tanzania(3)	T AE N Z EY N Y AH
tapes	T EY P S
target	T AA R G AH T
target(2)	T ER G AH T
tariff	T EH R AH F
tasks	T AE S K S
taste	T EY S T
tattoo	T AE T UW
taught	T AO T
taxation	T AE K S EY SH AH N
taxes	T AE K S AH Z
taxes(2)	T AE K S IH Z
taylor	T EY L ER
teach	T IY CH
teacher	T IY CH ER
teaching	T IY CH IH NG
teams	T IY M Z
tears	T EH R Z
tears(2)	T IH R Z
technical	T EH K N IH K AH L
technician	T EH K N IH SH AH N
technique	T EH K N IY K
techno	T EH K N OW
technological	T EH K N AH L AA JH IH K AH L
technology	T EH K N AA L AH JH IY
techrepublic	T EH K R AH P AH B L AH K
teddy	T EH D IY
teenage	T IY N EY JH
teens	T IY N Z
teeth	T IY TH
telecharger	T EH L AH CH AA R JH ER
telecom	T EH L AH K AA M
telecommunications	T EH L AH K AH M Y UW N AH K EY SH AH N Z
telephone	T EH L AH F OW N
telephony	T EH L AH F OW N IY
telescope	T EH L AH S K OW P
television	T EH L AH V IH ZH AH N
telling	T EH L IH NG
tells	T EH L Z
temperature	T EH M P R AH CH ER
temperature(2)	T EH M P ER AH CH ER
template	T EH M P L AH T
template(2)	T EH M P L EY T
temple	T EH M P AH L
temporal	T EH M P ER AH L
temporary	T EH M P ER EH R IY
tenant	T EH N AH N T
tender	T EH N D ER
tennessee	T EH N AH S IY
tennis	T EH N AH S
tennis(2)	T EH N IH S
tension	T EH N SH AH N
terminal	T ER M AH N AH L
termination	T ER M AH N EY SH AH N
terminology	T ER M IH N AA L AH JH IY
terms	T ER M Z
terrible	T EH R AH B AH L
territory	T EH R IH T AO R IY
terror	T EH R ER
terrorism	T EH R AH R IH Z AH M
terrorist	T EH R AH R IH S T
terry	T EH R IY
testament	T EH S T AH M AH N T
tested	T EH S T IH D
testimonials	T EH S T IH M OW N IY AH L Z
testimony	T EH S T IH M OW N IY
testing	T EH S T IH NG
tests	T EH S T S
texas	T EH K S AH S
textbook	T EH K S T B UH K
textile	T EH K S T AY L
texts	T EH K S T S
texture	T EH K S CH ER
thailand	T AY L AE N D
thanksgiving	TH AE NG K S G IH V IH NG
theater	TH IY EY T ER
theatre	TH IY AH T ER
themselves	DH EH M S EH L V Z
themselves(2)	DH AH M S EH L V Z
theology	TH IY AA L AH JH IY
theorem	TH IH R AH M
theoretical	TH IY ER EH T IH K AH L
therapeutic	TH EH R AH P Y UW T IH K
therapy	TH EH R AH P IY
thereafter	DH EH R AE F T ER
thereby	DH EH R B AY
therefore	DH EH R F AO R
thereof	DH EH R AH V
thermal	TH ER M AH L
thesaurus	TH AH S AO R AH S
thickness	TH IH K N AH S
thinking	TH IH NG K IH NG
thinkpad	TH IH NG K P AE D
thirty	TH ER D IY
thomas	T AA M AH S
thompson	T AA M P S AH N
thompson(2)	T AA M S AH N
thomson	T AA M S AH N
thorough	TH ER OW
thorough(2)	TH AO R OW
thoroughly	TH ER OW L IY
though	DH OW
thought	TH AO T
thousand	TH AW Z AH N D
thousand(2)	TH AW Z AH N
thread	TH R EH D
threat	TH R EH T
threatened	TH R EH T AH N D
threatening	TH R EH T AH N IH NG
threatening(2)	TH R EH T N IH NG
threesome	TH R IY S AH M
threshold	TH R EH SH OW L D
thriller	TH R IH L ER
throat	TH R OW T
through	TH R UW
throughout	TH R UW AW T
throwing	TH R OW IH NG
thrown	TH R OW N
thumbnail	TH AH M N EY L
thumbzilla	TH AH M B Z IH L AH
thunder	TH AH N D ER
thursday	TH ER Z D EY
thursday(2)	TH ER Z D IY
ticket	T IH K AH T
ticket(2)	T IH K IH T
tiffany	T IH F AH N IY
tiger	T AY G ER
tight	T AY T
tiles	T AY L Z
timber	T IH M B ER
timely	T AY M L IY
timer	T AY M ER
times	T AY M Z
timing	T AY M IH NG
timothy	T IH M AH TH IY
tions	T AY AH N Z
tired	T AY ER D
tires	T AY ER Z
tissue	T IH S Y UW
tissue(2)	T IH SH UW
titanium	T AY T EY N IY AH M
titans	T AY T AH N Z
title	T AY T AH L
titled	T AY T AH L D
titten	T IH T AH N
tobacco	T AH B AE K OW
tobago	T AH B EY G OW
toddler	T AA D L ER
together	T AH G EH DH ER
toilet	T OY L AH T
tolerance	T AA L ER AH N S
tomato	T AH M EY T OW
tomato(2)	T AH M AA T OW
tomorrow	T AH M AA R OW
tomorrow(2)	T UW M AA R OW
tonight	T AH N AY T
tonight(2)	T UW N AY T
toolbar	T UW L B AA R
toolbox	T UW L B AO K S
toolkit	T UW L K IH T
topless	T AA P L AH S
toronto	T ER AA N T OW
toronto(2)	T AO R AA N T OW
torture	T AO R CH ER
toshiba	T OW SH IY B AH
totally	T OW T AH L IY
touring	T UH R IH NG
tourism	T UH R IH Z AH M
tourist	T UH R AH S T
tourist(2)	T UH R IH S T
tournament	T UH R N AH M AH N T
toward	T AH W AO R D
toward(2)	T AO R D
township	T AW N SH IH P
toyota	T OW Y OW T AH
trackback	T R AE K B AE K
tracking	T R AE K IH NG
trademark	T R EY D M AA R K
trading	T R EY D IH NG
tradition	T R AH D IH SH AH N
traditional	T R AH D IH SH AH N AH L
traffic	T R AE F IH K
tragedy	T R AE JH AH D IY
trailer	T R EY L ER
trainer	T R EY N ER
training	T R EY N IH NG
tramadol	T R AE M AH D AH L
transaction	T R AE N Z AE K SH AH N
transcript	T R AE N S K R IH P T
transcription	T R AE N S K R IH P SH AH N
transexual	T R AE N S EH K S Y AH W AH
transfer	T R AE N S F ER
transferred	T R AE N S F ER D
transform	T R AE N S F AO R M
transformation	T R AE N S F ER M EY SH AH N
transit	T R AE N Z IH T
transition	T R AE N Z IH SH AH N
translate	T R AE N Z L EY T
translate(2)	T R AE N S L EY T
translated	T R AE N Z L EY T AH D
translated(2)	T R AE N S L EY T IH D
translation	T R AE N Z L EY SH AH N
translation(2)	T R AE N S L EY SH AH N
translator	T R AE N S L EY T ER
translator(2)	T R AE N Z L EY T ER
transmission	T R AE N S M IH SH AH N
transmission(2)	T R AE N Z M IH SH AH N
transmit	T R AE N Z M IH T
transmitted	T R AE N S M IH T IH D
transmitted(2)	T R AE N Z M IH T AH D
transparency	T R AE N S P EH R AH N S IY
transparent	T R AE N S P EH R AH N T
transport	T R AE N S P AO R T
transportation	T R AE N S P ER T EY SH AH N
transsexual	T R AE N S EH K SH Y UW AH L
traveler	T R AE V AH L ER
traveler(2)	T R AE V L ER
traveling	T R AE V AH L IH NG
traveling(2)	T R AE V L IH NG
traveller	T R AE V AH L ER
travelling	T R AE V AH L IH NG
travelling(2)	T R AE V L IH NG
travesti	T R AH V EH S T IY
treasure	T R EH ZH ER
treasurer	T R EH ZH ER ER
treasury	T R EH ZH ER IY
treatment	T R IY T M AH N T
treaty	T R IY T IY
trembl	T R EH M B L
tremendous	T R AH M EH N D AH S
tremendous(2)	T R IH M EH N D AH S
triangle	T R AY AE NG G AH L
tribal	T R AY B AH L
tribunal	T R AH B Y UW N AH L
tribune	T R IH B Y UW N
tribute	T R IH B Y UW T
trigger	T R IH G ER
trinidad	T R IH N IH D AE D
trinity	T R IH N AH T IY
trinity(2)	T R IH N IH T IY
tripadvisor	T R IH P AH D V AY Z ER
triple	T R IH P AH L
triumph	T R AY AH M F
trivia	T R IH V IY AH
tropical	T R AA P IH K AH L
trouble	T R AH B AH L
troubleshooting	T R AH B AH L SH UW T IH NG
trustee	T R AH S T IY
trying	T R AY IH NG
trying(2)	T R AY NG
tsunami	T S UW N AA M IY
tsunami(2)	S UW N AA M IY
tubes	T UW B Z
tucson	T UW S AA N
tuesday	T UW Z D IY
tuesday(2)	T UW Z D EY
tuesday(3)	T Y UW Z D EY
tuition	T Y UW IH SH AH N
tulsa	T AH L S AH
tumor	T UW M ER
tuner	T UW N ER
tunes	T UW N Z
tuning	T UW N IH NG
tunisia	T UW N IY ZH AH
tunnel	T AH N AH L
turbo	T ER B OW
turkey	T ER K IY
turkish	T ER K IH SH
turned	T ER N D
turner	T ER N ER
turning	T ER N IH NG
turns	T ER N Z
turtle	T ER T AH L
tutorial	T UW T AO R IY AH L
twelve	T W EH L V
twenty	T W EH N T IY
twice	T W AY S
twiki	T W IH K IY
twinks	T W IH NG K S
twins	T W IH N Z
twist	T W IH S T
tyler	T AY L ER
types	T AY P S
typical	T IH P AH K AH L
typical(2)	T IH P IH K AH L
typically	T IH P IH K L IY
typically(2)	T IH P IH K AH L IY
typing	T AY P IH NG
uganda	Y UW G AE N D AA
uganda(2)	Y UW G AA N D AA
ukraine	Y UW K R EY N
ultimate	AH L T AH M AH T
ultimately	AH L T AH M AH T L IY
ultra	AH L T R AH
ultram	AH L T R AH M
unable	AH N EY B AH L
unauthorized	AH N AO TH ER AY Z D
unavailable	AH N AH V EY L AH B AH L
uncertainty	AH N S ER T AH N T IY
uncle	AH NG K AH L
undefined	AH N D IH F AY N D
under	AH N D ER
undergraduate	AH N D ER G R AE JH AH W AH T
underground	AH N D ER G R AW N D
underlying	AH N D ER L AY IH NG
understand	AH N D ER S T AE N D
understanding	AH N D ER S T AE N D IH NG
understood	AH N D ER S T UH D
undertake	AH N D ER T EY K
undertaken	AH N D ER T EY K AH N
underwear	AH N D ER W EH R
unemployment	AH N IH M P L OY M AH N T
unexpected	AH N IH K S P EH K T IH D
unfortunately	AH N F AO R CH AH N AH T L IY
unfortunately(2)	AH N F AO R CH UW N AH T L IY
unified	Y UW N AH F AY D
uniform	Y UW N AH F AO R M
union	Y UW N Y AH N
uniprotkb	Y UW N AH P R AA T B
unique	Y UW N IY K
united	Y UW N AY T AH D
united(2)	Y UW N AY T IH D
units	Y UW N AH T S
units(2)	Y UW N IH T S
unity	Y UW N AH T IY
unity(2)	Y UW N IH T IY
universal	Y UW N AH V ER S AH L
universe	Y UW N AH V ER S
university	Y UW N AH V ER S AH T IY
unknown	AH N N OW N
unless	AH N L EH S
unlike	AH N L AY K
unlikely	AH N L AY K L IY
unlimited	AH N L IH M AH T AH D
unlimited(2)	AH N L IH M IH T IH D
unlock	AH N L AA K
unnecessary	AH N N EH S AH S EH R IY
unsigned	AH N S AY N D
unsubscribe	AH N S AH B S K R AY B
until	AH N T IH L
untitled	AH N T AY T AH L D
unusual	AH N Y UW ZH UW AH L
unusual(2)	AH N Y UW ZH W AH L
unwrap	AH N R AE P
upcoming	AH P K AH M IH NG
update	AH P D EY T
updated	AH P D EY T AH D
updated(2)	AH P D EY T IH D
updating	AH P D EY T IH NG
upgrade	AH P G R EY D
upgrading	AH P G R EY D IH NG
upload	AH P L OW D
upper	AH P ER
upset	AH P S EH T
upskirt	AH P S K ER T
urban	ER B AH N
urgent	ER JH AH N T
uruguay	Y ER AH G W EY
uruguay(2)	Y ER AH G W AY
usage	Y UW S AH JH
usage(2)	Y UW S IH JH
useful	Y UW S F AH L
username	Y UW S ER N EY M
users	Y UW Z ER Z
using	Y UW Z IH NG
usual	Y UW ZH AH W AH L
usual(2)	Y UW ZH UW AH L
usually	Y UW ZH AH W AH L IY
usually(2)	Y UW ZH AH L IY
utility	Y UW T IH L AH T IY
utilization	Y UW T AH L AH Z EY SH AH N
utilize	Y UW T AH L AY Z
utils	Y UW T AH L Z
uzbekistan	UW Z B EH K IH S T AE N
vacancies	V EY K AH N S IY Z
vacation	V EY K EY SH AH N
vaccine	V AE K S IY N
vacuum	V AE K Y UW M
vagina	V AH JH AY N AH
valentine	V AE L AH N T AY N
valid	V AE L IH D
validation	V AE L AH D EY SH AH N
validity	V AH L IH D IH T IY
valium	V AE L IY AH M
valley	V AE L IY
valuable	V AE L Y AH B AH L
valuable(2)	V AE L Y UW B AH L
valuation	V AE L Y UW EY SH AH N
value	V AE L Y UW
valued	V AE L Y UW D
valve	V AE L V
vampire	V AE M P AY R
vancouver	V AE N K UW V ER
vanilla	V AH N IH L AH
variable	V EH R IY AH B AH L
variance	V EH R IY AH N S
variation	V EH R IY EY SH AH N
variety	V ER AY AH T IY
various	V EH R IY AH S
varying	V EH R IY IH NG
vatican	V AE T IH K AH N
vault	V AO L T
vbulletin	V B UH L AH T AH N
vector	V EH K T ER
vegas	V EY G AH S
vegetable	V EH JH T AH B AH L
vegetarian	V EH JH AH T EH R IY AH N
vegetation	V EH JH AH T EY SH AH N
vehicle	V IY HH IH K AH L
vehicle(2)	V IY IH K AH L
velocity	V AH L AA S AH T IY
velvet	V EH L V AH T
vendor	V EH N D ER
venezuela	V EH N IH Z W EY L AH
venice	V EH N AH S
venice(2)	V EH N IH S
venture	V EH N CH ER
venue	V EH N Y UW
verde	V ER D IY
verification	V EH R AH F AH K EY SH AH N
verizon	V EH R AY Z AH N
vermont	V ER M AA N T
verse	V ER S
version	V ER ZH AH N
vertical	V ER T IH K AH L
verzeichnis	V AH R Z IY K N AH S
vessel	V EH S AH L
veteran	V EH T ER AH N
veteran(2)	V EH T R AH N
veterinary	V EH T R AH N EH R IY
viagra	V AY AE G R AH
vibrator	V AY B R EY T ER
victim	V IH K T IH M
victor	V IH K T ER
victoria	V IH K T AO R IY AH
victory	V IH K T AH R IY
video	V IH D IY OW
vienna	V IY EH N AH
vietnam	V IY EH T N AA M
vietnamese	V IY EH T N AA M IY S
viewed	V Y UW D
viewer	V Y UW ER
viewing	V Y UW IH NG
viewpicture	V Y UW P IH K CH ER
views	V Y UW Z
viking	V AY K IH NG
villa	V IH L AH
village	V IH L AH JH
village(2)	V IH L IH JH
vincent	V IH N S EH N T
vincent(2)	V IH N S IH N T
vintage	V IH N T IH JH
vinyl	V AY N AH L
violation	V AY AH L EY SH AH N
violence	V AY AH L AH N S
violent	V AY AH L AH N T
violin	V AY AH L IH N
viral	V AY R AH L
virgin	V ER JH IH N
virginia	V ER JH IH N Y AH
virtual	V ER CH UW AH L
virtually	V ER CH UW AH L IY
virtually(2)	V ER CH UW L IY
virtue	V ER CH UW
virus	V AY R AH S
visibility	V IH Z AH B IH L IH T IY
visible	V IH Z AH B AH L
vision	V IH ZH AH N
visit	V IH Z IH T
visiting	V IH Z IH T IH NG
visitor	V IH Z IH T ER
vista	V IH S T AH
visual	V IH ZH AH W AH L
vital	V AY T AH L
vitamin	V AY T AH M AH N
vocabulary	V OW K AE B Y AH L EH R IY
vocal	V OW K AH L
vocational	V OW K EY SH AH N AH L
voice	V OY S
volkswagen	V OW L K S W AE G AH N
volleyball	V AA L IY B AO L
voltage	V OW L T AH JH
voltage(2)	V OW L T IH JH
volume	V AA L Y UW M
voluntary	V AA L AH N T EH R IY
volunteer	V AA L AH N T IH R
volvo	V OW L V OW
voted	V OW T AH D
voted(2)	V OW T IH D
voters	V OW T ER Z
votes	V OW T S
voting	V OW T IH NG
voyeur	V OY Y UW R
voyeurweb	V OY UW R W AH B
voyuer	V OY UW W AH R
vsnet	V S N EH T
vulnerability	V AH L N ER AH B IH L IH T IY
vulnerable	V AH L N ER AH B AH L
wagner	W AE G N ER
wagner(2)	V AA G N ER
waiting	W EY T IH NG
waiver	W EY V ER
walked	W AO K T
walker	W AO K ER
walking	W AO K IH NG
wallace	W AO L AH S
wallace(2)	W AO L IH S
wallet	W AO L AH T
wallpaper	W AO L P EY P ER
walnut	W AO L N AH T
walter	W AO L T ER
wanted	W AO N T IH D
wanting	W AA N T IH NG
wanting(2)	W AA N IH NG
warcraft	W AO R K R AE F T
warehouse	W EH R HH AW S
warming	W AO R M IH NG
warned	W AO R N D
warner	W AO R N ER
warning	W AO R N IH NG
warrant	W AO R AH N T
warranty	W AO R AH N T IY
warren	W AO R AH N
warrior	W AO R IY ER
warrior(2)	W AO R Y ER
washer	W AA SH ER
washing	W AA SH IH NG
washington	W AA SH IH NG T AH N
washington(2)	W AO SH IH NG T AH N
watching	W AA CH IH NG
waterproof	W AO T ER P R UW F
watershed	W AO T ER SH EH D
watson	W AA T S AH N
wealth	W EH L TH
weapon	W EH P AH N
wearing	W EH R IH NG
weather	W EH DH ER
webcam	W EH B K AE M
webcast	W EH B K AE S T
weblog	W EH B L AA G
webmaster	W EH B M AE S T ER
webpage	W EH B P EY JH
webshots	W EH B SH AA T S
website	W EH B S AY T
webster	W EH B S T ER
wedding	W EH D IH NG
wednesday	W EH N Z D IY
wednesday(2)	W EH N Z D EY
weekend	W IY K EH N D
weekend(2)	W IY K IH N D
weekly	W IY K L IY
weeks	W IY K S
weight	W EY T
weird	W IH R D
welcome	W EH L K AH M
welding	W EH L D IH NG
welfare	W EH L F EH R
wellington	W EH L IH NG T AH N
wellness	W EH L N AH S
wells	W EH L Z
welsh	W EH L CH
welsh(2)	W EH L SH
wendy	W EH N D IY
wesley	W EH S L IY
western	W EH S T ER N
western(2)	HH W EH S T ER N
westminster	W EH S T M IH N S T ER
whatever	W AH T EH V ER
whatever(2)	HH W AH T EH V ER
whenever	W EH N EH V ER
whenever(2)	HH W EH N EH V ER
whereas	W EH R AE Z
whereas(2)	HH W EH R AE Z
wherever	W EH R EH V ER
wherever(2)	HH W EH R EH V ER
whether	W EH DH ER
whether(2)	HH W EH DH ER
whilst	W AY L S T
wholesale	HH OW L S EY L
wichita	W IH CH AH T AO
wicked	W IH K AH D
widely	W AY D L IY
wider	W AY D ER
widescreen	W AY D S K R IY N
widespread	W AY D S P R EH D
width	W IH D TH
wikipedia	W IH K IY P IY D IY AH
wilderness	W IH L D ER N AH S
wildlife	W AY L D L AY F
wiley	W AY L IY
william	W IH L Y AH M
willing	W IH L IH NG
willow	W IH L OW
wilson	W IH L S AH N
window	W IH N D OW
winds	W IH N D Z
winds(2)	W AY N D Z
windsor	W IH N Z ER
wines	W AY N Z
wings	W IH NG Z
winner	W IH N ER
winning	W IH N IH NG
winston	W IH N S T AH N
winter	W IH N T ER
wired	W AY ER D
wired(2)	W AY R D
wireless	W AY R L IH S
wires	W AY ER Z
wires(2)	W AY R Z
wiring	W AY R IH NG
wisconsin	W IH S K AA N S AH N
wisdom	W IH Z D AH M
wishes	W IH SH IH Z
wishing	W IH SH IH NG
wishlist	W IH SH L IH S T
witch	W IH CH
withdrawal	W IH DH D R AO AH L
withdrawal(2)	W IH TH D R AO AH L
within	W IH DH IH N
within(2)	W IH TH IH N
without	W IH TH AW T
without(2)	W IH DH AW T
witness	W IH T N AH S
wives	W AY V Z
wizard	W IH Z ER D
woman	W UH M AH N
women	W IH M AH N
wonder	W AH N D ER
wonderful	W AH N D ER F AH L
wondering	W AH N D ER IH NG
wooden	W UH D AH N
woods	W UH D Z
worcester	W UH S T ER
wordpress	W ER D P R EH S
words	W ER D Z
worked	W ER K T
worker	W ER K ER
workflow	W ER K F L OW
workforce	W ER K F AO R S
working	W ER K IH NG
workout	W ER K AW T
workplace	W ER K P L EY S
works	W ER K S
workshop	W ER K SH AA P
workstation	W ER K S T EY SH AH N
world	W ER L D
worldcat	W ER L D K AE T
worldsex	W ER L D S EH K S
worldwide	W ER L D W AY D
worry	W ER IY
worse	W ER S
worship	W ER SH AH P
worship(2)	W ER SH IH P
worst	W ER S T
worth	W ER TH
worthy	W ER DH IY
would	W UH D
wound	W AW N D
wound(2)	W UW N D
wrapped	R AE P T
wrapping	R AE P IH NG
wrestling	R EH S L IH NG
wrestling(2)	R EH S AH L IH NG
wright	R AY T
wrist	R IH S T
write	R AY T
writer	R AY T ER
writing	R AY T IH NG
written	R IH T AH N
wrong	R AO NG
wrote	R OW T
wyoming	W AY OW M IH NG
xanax	Z AE N AE K S
xerox	Z IH R AA K S
xhtml	EH K S EY CH T IY EH M L
yacht	Y AA T
yahoo	Y AA HH UW
yamaha	Y AA M AA HH AA
yards	Y AA R D Z
yearly	Y IH R L IY
years	Y IH R Z
yeast	Y IY S T
yellow	Y EH L OW
yemen	Y EH M AH N
yesterday	Y EH S T ER D EY
yesterday(2)	Y EH S T ER D IY
yield	Y IY L D
yorkshire	Y AO R K SH ER
young	Y AH NG
younger	Y AH NG G ER
yours	Y UH R Z
yours(2)	Y AO R Z
yours(3)	Y ER Z
yourself	Y ER S EH L F
yourself(2)	Y UH R S EH L F
yourself(3)	Y AO R S EH L F
youth	Y UW TH
yugoslavia	Y UW G OW S L AA V IY AH
yukon	Y UW K AA N
zambia	Z AE M B IY AH
zdnet	Z D N EH T
zealand	Z IY L AH N D
zimbabwe	Z IH M B AA B W EY
zoloft	Z AA L AA F T
zoloft(2)	Z OW L AA F T
zones	Z OW N Z
zoning	Z OW N IH NG
zoophilia	Z UW F IH L Y AH
zshops	Z SH AA P S